,Week,Time,Away,Home,Away_Score,Home_Score,Diff
0,1,8:20PM,Buffalo Bills_2022,Los Angeles Rams_2022,31,10,-21
1,1,1:00PM,New Orleans Saints_2022,Atlanta Falcons_2022,27,26,-1
2,1,1:00PM,Cleveland Browns_2022,Carolina Panthers_2022,26,24,-2
3,1,1:00PM,San Francisco 49ers_2022,Chicago Bears_2022,10,19,9
4,1,1:00PM,Pittsburgh Steelers_2022,Cincinnati Bengals_2022,23,20,-3
5,1,1:00PM,Indianapolis Colts_2022,Houston Texans_2022,20,20,0
6,1,1:00PM,Philadelphia Eagles_2022,Detroit Lions_2022,38,35,-3
7,1,1:00PM,Jacksonville Jaguars_2022,Washington Commanders_2022,22,28,6
8,1,1:00PM,New England Patriots_2022,Miami Dolphins_2022,7,20,13
9,1,1:00PM,Baltimore Ravens_2022,New York Jets_2022,24,9,-15
10,1,4:25PM,Kansas City Chiefs_2022,Arizona Cardinals_2022,44,21,-23
11,1,4:25PM,Green Bay Packers_2022,Minnesota Vikings_2022,7,23,16
12,1,4:25PM,New York Giants_2022,Tennessee Titans_2022,21,20,-1
13,1,4:25PM,Las Vegas Raiders_2022,Los Angeles Chargers_2022,19,24,5
14,1,8:20PM,Tampa Bay Buccaneers_2022,Dallas Cowboys_2022,19,3,-16
15,1,8:20PM,Denver Broncos_2022,Seattle Seahawks_2022,16,17,1
16,2,8:15PM,Los Angeles Chargers_2022,Kansas City Chiefs_2022,24,27,3
17,2,1:00PM,Carolina Panthers_2022,New York Giants_2022,16,19,3
18,2,1:00PM,New York Jets_2022,Cleveland Browns_2022,31,30,-1
19,2,1:00PM,Indianapolis Colts_2022,Jacksonville Jaguars_2022,0,24,24
20,2,1:00PM,Washington Commanders_2022,Detroit Lions_2022,27,36,9
21,2,1:00PM,Miami Dolphins_2022,Baltimore Ravens_2022,42,38,-4
22,2,1:00PM,Tampa Bay Buccaneers_2022,New Orleans Saints_2022,20,10,-10
23,2,1:00PM,New England Patriots_2022,Pittsburgh Steelers_2022,17,14,-3
24,2,4:05PM,Atlanta Falcons_2022,Los Angeles Rams_2022,27,31,4
25,2,4:05PM,Seattle Seahawks_2022,San Francisco 49ers_2022,7,27,20
26,2,4:25PM,Cincinnati Bengals_2022,Dallas Cowboys_2022,17,20,3
27,2,4:25PM,Arizona Cardinals_2022,Las Vegas Raiders_2022,29,23,-6
28,2,4:25PM,Houston Texans_2022,Denver Broncos_2022,9,16,7
29,2,8:20PM,Chicago Bears_2022,Green Bay Packers_2022,10,27,17
30,2,7:15PM,Tennessee Titans_2022,Buffalo Bills_2022,7,41,34
31,2,8:30PM,Minnesota Vikings_2022,Philadelphia Eagles_2022,7,24,17
32,3,8:15PM,Pittsburgh Steelers_2022,Cleveland Browns_2022,17,29,12
33,3,1:00PM,Buffalo Bills_2022,Miami Dolphins_2022,19,21,2
34,3,1:00PM,New Orleans Saints_2022,Carolina Panthers_2022,14,22,8
35,3,1:00PM,Houston Texans_2022,Chicago Bears_2022,20,23,3
36,3,1:00PM,Cincinnati Bengals_2022,New York Jets_2022,27,12,-15
37,3,1:00PM,Kansas City Chiefs_2022,Indianapolis Colts_2022,17,20,3
38,3,1:00PM,Detroit Lions_2022,Minnesota Vikings_2022,24,28,4
39,3,1:00PM,Baltimore Ravens_2022,New England Patriots_2022,37,26,-11
40,3,1:00PM,Las Vegas Raiders_2022,Tennessee Titans_2022,22,24,2
41,3,1:00PM,Philadelphia Eagles_2022,Washington Commanders_2022,24,8,-16
42,3,4:05PM,Jacksonville Jaguars_2022,Los Angeles Chargers_2022,38,10,-28
43,3,4:25PM,Atlanta Falcons_2022,Seattle Seahawks_2022,27,23,-4
44,3,4:25PM,Los Angeles Rams_2022,Arizona Cardinals_2022,20,12,-8
45,3,4:25PM,Green Bay Packers_2022,Tampa Bay Buccaneers_2022,14,12,-2
46,3,8:20PM,San Francisco 49ers_2022,Denver Broncos_2022,10,11,1
47,3,8:15PM,Dallas Cowboys_2022,New York Giants_2022,23,16,-7
48,4,8:15PM,Miami Dolphins_2022,Cincinnati Bengals_2022,15,27,12
49,4,9:30AM,Minnesota Vikings_2022,New Orleans Saints_2022,28,25,-3
50,4,1:00PM,Cleveland Browns_2022,Atlanta Falcons_2022,20,23,3
51,4,1:00PM,Buffalo Bills_2022,Baltimore Ravens_2022,23,20,-3
52,4,1:00PM,Chicago Bears_2022,New York Giants_2022,12,20,8
53,4,1:00PM,Tennessee Titans_2022,Indianapolis Colts_2022,24,17,-7
54,4,1:00PM,Washington Commanders_2022,Dallas Cowboys_2022,10,25,15
55,4,1:00PM,Seattle Seahawks_2022,Detroit Lions_2022,48,45,-3
56,4,1:00PM,Los Angeles Chargers_2022,Houston Texans_2022,34,24,-10
57,4,1:00PM,Jacksonville Jaguars_2022,Philadelphia Eagles_2022,21,29,8
58,4,1:00PM,New York Jets_2022,Pittsburgh Steelers_2022,24,20,-4
59,4,4:05PM,Arizona Cardinals_2022,Carolina Panthers_2022,26,16,-10
60,4,4:25PM,Denver Broncos_2022,Las Vegas Raiders_2022,23,32,9
61,4,4:25PM,New England Patriots_2022,Green Bay Packers_2022,24,27,3
62,4,8:20PM,Kansas City Chiefs_2022,Tampa Bay Buccaneers_2022,41,31,-10
63,4,8:15PM,Los Angeles Rams_2022,San Francisco 49ers_2022,9,24,15
64,5,8:15PM,Indianapolis Colts_2022,Denver Broncos_2022,12,9,-3
65,5,9:30AM,New York Giants_2022,Green Bay Packers_2022,27,22,-5
66,5,1:00PM,Atlanta Falcons_2022,Tampa Bay Buccaneers_2022,15,21,6
67,5,1:00PM,Pittsburgh Steelers_2022,Buffalo Bills_2022,3,38,35
68,5,1:00PM,Chicago Bears_2022,Minnesota Vikings_2022,22,29,7
69,5,1:00PM,Los Angeles Chargers_2022,Cleveland Browns_2022,30,28,-2
70,5,1:00PM,Detroit Lions_2022,New England Patriots_2022,0,29,29
71,5,1:00PM,Houston Texans_2022,Jacksonville Jaguars_2022,13,6,-7
72,5,1:00PM,Miami Dolphins_2022,New York Jets_2022,17,40,23
73,5,1:00PM,Seattle Seahawks_2022,New Orleans Saints_2022,32,39,7
74,5,1:00PM,Tennessee Titans_2022,Washington Commanders_2022,21,17,-4
75,5,4:05PM,San Francisco 49ers_2022,Carolina Panthers_2022,37,15,-22
76,5,4:25PM,Philadelphia Eagles_2022,Arizona Cardinals_2022,20,17,-3
77,5,4:25PM,Dallas Cowboys_2022,Los Angeles Rams_2022,22,10,-12
78,5,8:20PM,Cincinnati Bengals_2022,Baltimore Ravens_2022,17,19,2
79,5,8:15PM,Las Vegas Raiders_2022,Kansas City Chiefs_2022,29,30,1
80,6,8:15PM,Washington Commanders_2022,Chicago Bears_2022,12,7,-5
81,6,1:00PM,San Francisco 49ers_2022,Atlanta Falcons_2022,14,28,14
82,6,1:00PM,Cincinnati Bengals_2022,New Orleans Saints_2022,30,26,-4
83,6,1:00PM,New England Patriots_2022,Cleveland Browns_2022,38,15,-23
84,6,1:00PM,Jacksonville Jaguars_2022,Indianapolis Colts_2022,27,34,7
85,6,1:00PM,New York Jets_2022,Green Bay Packers_2022,27,10,-17
86,6,1:00PM,Minnesota Vikings_2022,Miami Dolphins_2022,24,16,-8
87,6,1:00PM,Baltimore Ravens_2022,New York Giants_2022,20,24,4
88,6,1:00PM,Tampa Bay Buccaneers_2022,Pittsburgh Steelers_2022,18,20,2
89,6,4:05PM,Carolina Panthers_2022,Los Angeles Rams_2022,10,24,14
90,6,4:05PM,Arizona Cardinals_2022,Seattle Seahawks_2022,9,19,10
91,6,4:25PM,Buffalo Bills_2022,Kansas City Chiefs_2022,24,20,-4
92,6,8:20PM,Dallas Cowboys_2022,Philadelphia Eagles_2022,17,26,9
93,6,8:15PM,Denver Broncos_2022,Los Angeles Chargers_2022,16,19,3
94,7,8:15PM,New Orleans Saints_2022,Arizona Cardinals_2022,34,42,8
95,7,1:00PM,Atlanta Falcons_2022,Cincinnati Bengals_2022,17,35,18
96,7,1:00PM,Tampa Bay Buccaneers_2022,Carolina Panthers_2022,3,21,18
97,7,1:00PM,Cleveland Browns_2022,Baltimore Ravens_2022,20,23,3
98,7,1:00PM,Indianapolis Colts_2022,Tennessee Titans_2022,10,19,9
99,7,1:00PM,Detroit Lions_2022,Dallas Cowboys_2022,6,24,18
100,7,1:00PM,Green Bay Packers_2022,Washington Commanders_2022,21,23,2
101,7,1:00PM,New York Giants_2022,Jacksonville Jaguars_2022,23,17,-6
102,7,4:05PM,Houston Texans_2022,Las Vegas Raiders_2022,20,38,18
103,7,4:05PM,New York Jets_2022,Denver Broncos_2022,16,9,-7
104,7,4:25PM,Kansas City Chiefs_2022,San Francisco 49ers_2022,44,23,-21
105,7,4:25PM,Seattle Seahawks_2022,Los Angeles Chargers_2022,37,23,-14
106,7,8:20PM,Pittsburgh Steelers_2022,Miami Dolphins_2022,10,16,6
107,7,8:15PM,Chicago Bears_2022,New England Patriots_2022,33,14,-19
108,8,8:15PM,Baltimore Ravens_2022,Tampa Bay Buccaneers_2022,27,22,-5
109,8,9:30AM,Denver Broncos_2022,Jacksonville Jaguars_2022,21,17,-4
110,8,1:00PM,Miami Dolphins_2022,Detroit Lions_2022,31,27,-4
111,8,1:00PM,Pittsburgh Steelers_2022,Philadelphia Eagles_2022,13,35,22
112,8,1:00PM,Carolina Panthers_2022,Atlanta Falcons_2022,34,37,3
113,8,1:00PM,Chicago Bears_2022,Dallas Cowboys_2022,29,49,20
114,8,1:00PM,Arizona Cardinals_2022,Minnesota Vikings_2022,26,34,8
115,8,1:00PM,Las Vegas Raiders_2022,New Orleans Saints_2022,0,24,24
116,8,1:00PM,New England Patriots_2022,New York Jets_2022,22,17,-5
117,8,4:05PM,Tennessee Titans_2022,Houston Texans_2022,17,10,-7
118,8,4:25PM,San Francisco 49ers_2022,Los Angeles Rams_2022,31,14,-17
119,8,4:25PM,Washington Commanders_2022,Indianapolis Colts_2022,17,16,-1
120,8,4:25PM,New York Giants_2022,Seattle Seahawks_2022,13,27,14
121,8,8:20PM,Green Bay Packers_2022,Buffalo Bills_2022,17,27,10
122,8,8:15PM,Cincinnati Bengals_2022,Cleveland Browns_2022,13,32,19
123,9,8:15PM,Philadelphia Eagles_2022,Houston Texans_2022,29,17,-12
124,9,1:00PM,Buffalo Bills_2022,New York Jets_2022,17,20,3
125,9,1:00PM,Green Bay Packers_2022,Detroit Lions_2022,9,15,6
126,9,1:00PM,Minnesota Vikings_2022,Washington Commanders_2022,20,17,-3
127,9,1:00PM,Los Angeles Chargers_2022,Atlanta Falcons_2022,20,17,-3
128,9,1:00PM,Carolina Panthers_2022,Cincinnati Bengals_2022,21,42,21
129,9,1:00PM,Miami Dolphins_2022,Chicago Bears_2022,35,32,-3
130,9,1:00PM,Indianapolis Colts_2022,New England Patriots_2022,3,26,23
131,9,1:00PM,Las Vegas Raiders_2022,Jacksonville Jaguars_2022,20,27,7
132,9,4:05PM,Seattle Seahawks_2022,Arizona Cardinals_2022,31,21,-10
133,9,4:25PM,Los Angeles Rams_2022,Tampa Bay Buccaneers_2022,13,16,3
134,9,8:20PM,Tennessee Titans_2022,Kansas City Chiefs_2022,17,20,3
135,9,8:15PM,Baltimore Ravens_2022,New Orleans Saints_2022,27,13,-14
136,10,8:15PM,Atlanta Falcons_2022,Carolina Panthers_2022,15,25,10
137,10,9:30AM,Seattle Seahawks_2022,Tampa Bay Buccaneers_2022,16,21,5
138,10,1:00PM,Minnesota Vikings_2022,Buffalo Bills_2022,33,30,-3
139,10,1:00PM,Cleveland Browns_2022,Miami Dolphins_2022,17,39,22
140,10,1:00PM,Denver Broncos_2022,Tennessee Titans_2022,10,17,7
141,10,1:00PM,Houston Texans_2022,New York Giants_2022,16,24,8
142,10,1:00PM,Detroit Lions_2022,Chicago Bears_2022,31,30,-1
143,10,1:00PM,Jacksonville Jaguars_2022,Kansas City Chiefs_2022,17,27,10
144,10,1:00PM,New Orleans Saints_2022,Pittsburgh Steelers_2022,10,20,10
145,10,4:05PM,Indianapolis Colts_2022,Las Vegas Raiders_2022,25,20,-5
146,10,4:25PM,Dallas Cowboys_2022,Green Bay Packers_2022,28,31,3
147,10,4:25PM,Arizona Cardinals_2022,Los Angeles Rams_2022,27,17,-10
148,10,8:20PM,Los Angeles Chargers_2022,San Francisco 49ers_2022,16,22,6
149,10,8:15PM,Washington Commanders_2022,Philadelphia Eagles_2022,32,21,-11
150,11,8:15PM,Tennessee Titans_2022,Green Bay Packers_2022,27,17,-10
151,11,1:00PM,Cleveland Browns_2022,Buffalo Bills_2022,23,31,8
152,11,1:00PM,Detroit Lions_2022,New York Giants_2022,31,18,-13
153,11,1:00PM,Washington Commanders_2022,Houston Texans_2022,23,10,-13
154,11,1:00PM,New York Jets_2022,New England Patriots_2022,3,10,7
155,11,1:00PM,Chicago Bears_2022,Atlanta Falcons_2022,24,27,3
156,11,1:00PM,Carolina Panthers_2022,Baltimore Ravens_2022,3,13,10
157,11,1:00PM,Philadelphia Eagles_2022,Indianapolis Colts_2022,17,16,-1
158,11,1:00PM,Los Angeles Rams_2022,New Orleans Saints_2022,20,27,7
159,11,4:05PM,Las Vegas Raiders_2022,Denver Broncos_2022,22,16,-6
160,11,4:25PM,Cincinnati Bengals_2022,Pittsburgh Steelers_2022,37,30,-7
161,11,4:25PM,Dallas Cowboys_2022,Minnesota Vikings_2022,40,3,-37
162,11,8:20PM,Kansas City Chiefs_2022,Los Angeles Chargers_2022,30,27,-3
163,11,8:15PM,San Francisco 49ers_2022,Arizona Cardinals_2022,38,10,-28
164,12,12:30PM,Buffalo Bills_2022,Detroit Lions_2022,28,25,-3
165,12,4:30PM,New York Giants_2022,Dallas Cowboys_2022,20,28,8
166,12,8:20PM,New England Patriots_2022,Minnesota Vikings_2022,26,33,7
167,12,1:00PM,Cincinnati Bengals_2022,Tennessee Titans_2022,20,16,-4
168,12,1:00PM,Tampa Bay Buccaneers_2022,Cleveland Browns_2022,17,23,6
169,12,1:00PM,Houston Texans_2022,Miami Dolphins_2022,15,30,15
170,12,1:00PM,Baltimore Ravens_2022,Jacksonville Jaguars_2022,27,28,1
171,12,1:00PM,Atlanta Falcons_2022,Washington Commanders_2022,13,19,6
172,12,1:00PM,Denver Broncos_2022,Carolina Panthers_2022,10,23,13
173,12,1:00PM,Chicago Bears_2022,New York Jets_2022,10,31,21
174,12,4:05PM,Las Vegas Raiders_2022,Seattle Seahawks_2022,40,34,-6
175,12,4:05PM,Los Angeles Chargers_2022,Arizona Cardinals_2022,25,24,-1
176,12,4:25PM,Los Angeles Rams_2022,Kansas City Chiefs_2022,10,26,16
177,12,4:25PM,New Orleans Saints_2022,San Francisco 49ers_2022,0,13,13
178,12,8:20PM,Green Bay Packers_2022,Philadelphia Eagles_2022,33,40,7
179,12,8:15PM,Pittsburgh Steelers_2022,Indianapolis Colts_2022,24,17,-7
180,13,8:15PM,Buffalo Bills_2022,New England Patriots_2022,24,10,-14
181,13,1:00PM,Cleveland Browns_2022,Houston Texans_2022,27,14,-13
182,13,1:00PM,Denver Broncos_2022,Baltimore Ravens_2022,9,10,1
183,13,1:00PM,Jacksonville Jaguars_2022,Detroit Lions_2022,14,40,26
184,13,1:00PM,New York Jets_2022,Minnesota Vikings_2022,22,27,5
185,13,1:00PM,Washington Commanders_2022,New York Giants_2022,20,20,0
186,13,1:00PM,Tennessee Titans_2022,Philadelphia Eagles_2022,10,35,25
187,13,1:00PM,Pittsburgh Steelers_2022,Atlanta Falcons_2022,19,16,-3
188,13,1:00PM,Green Bay Packers_2022,Chicago Bears_2022,28,19,-9
189,13,4:05PM,Miami Dolphins_2022,San Francisco 49ers_2022,17,33,16
190,13,4:05PM,Seattle Seahawks_2022,Los Angeles Rams_2022,27,23,-4
191,13,4:25PM,Kansas City Chiefs_2022,Cincinnati Bengals_2022,24,27,3
192,13,4:25PM,Los Angeles Chargers_2022,Las Vegas Raiders_2022,20,27,7
193,13,8:20PM,Indianapolis Colts_2022,Dallas Cowboys_2022,19,54,35
194,13,8:15PM,New Orleans Saints_2022,Tampa Bay Buccaneers_2022,16,17,1
195,14,8:15PM,Las Vegas Raiders_2022,Los Angeles Rams_2022,16,17,1
196,14,1:00PM,New York Jets_2022,Buffalo Bills_2022,12,20,8
197,14,1:00PM,Cleveland Browns_2022,Cincinnati Bengals_2022,10,23,13
198,14,1:00PM,Houston Texans_2022,Dallas Cowboys_2022,23,27,4
199,14,1:00PM,Minnesota Vikings_2022,Detroit Lions_2022,23,34,11
200,14,1:00PM,Jacksonville Jaguars_2022,Tennessee Titans_2022,36,22,-14
201,14,1:00PM,Philadelphia Eagles_2022,New York Giants_2022,48,22,-26
202,14,1:00PM,Baltimore Ravens_2022,Pittsburgh Steelers_2022,16,14,-2
203,14,4:20PM,Kansas City Chiefs_2022,Denver Broncos_2022,34,28,-6
204,14,4:25PM,Carolina Panthers_2022,Seattle Seahawks_2022,30,24,-6
205,14,4:25PM,Tampa Bay Buccaneers_2022,San Francisco 49ers_2022,7,35,28
206,14,8:20PM,Miami Dolphins_2022,Los Angeles Chargers_2022,17,23,6
207,14,8:15PM,New England Patriots_2022,Arizona Cardinals_2022,27,13,-14
208,15,8:15PM,San Francisco 49ers_2022,Seattle Seahawks_2022,21,13,-8
209,15,1:00PM,Indianapolis Colts_2022,Minnesota Vikings_2022,36,39,3
210,15,4:30PM,Baltimore Ravens_2022,Cleveland Browns_2022,3,13,10
211,15,8:15PM,Miami Dolphins_2022,Buffalo Bills_2022,29,32,3
212,15,1:00PM,Atlanta Falcons_2022,New Orleans Saints_2022,18,21,3
213,15,1:00PM,Pittsburgh Steelers_2022,Carolina Panthers_2022,24,16,-8
214,15,1:00PM,Philadelphia Eagles_2022,Chicago Bears_2022,25,20,-5
215,15,1:00PM,Dallas Cowboys_2022,Jacksonville Jaguars_2022,34,40,6
216,15,1:00PM,Detroit Lions_2022,New York Jets_2022,20,17,-3
217,15,1:00PM,Kansas City Chiefs_2022,Houston Texans_2022,30,24,-6
218,15,4:05PM,Arizona Cardinals_2022,Denver Broncos_2022,15,24,9
219,15,4:05PM,New England Patriots_2022,Las Vegas Raiders_2022,24,30,6
220,15,4:25PM,Cincinnati Bengals_2022,Tampa Bay Buccaneers_2022,34,23,-11
221,15,4:25PM,Tennessee Titans_2022,Los Angeles Chargers_2022,14,17,3
222,15,8:15PM,New York Giants_2022,Washington Commanders_2022,20,12,-8
223,15,8:15PM,Los Angeles Rams_2022,Green Bay Packers_2022,12,24,12
224,16,8:15PM,Jacksonville Jaguars_2022,New York Jets_2022,19,3,-16
225,16,1:00PM,Atlanta Falcons_2022,Baltimore Ravens_2022,9,17,8
226,16,1:00PM,Buffalo Bills_2022,Chicago Bears_2022,35,13,-22
227,16,1:00PM,Detroit Lions_2022,Carolina Panthers_2022,23,37,14
228,16,1:00PM,Cincinnati Bengals_2022,New England Patriots_2022,22,18,-4
229,16,1:00PM,New Orleans Saints_2022,Cleveland Browns_2022,17,10,-7
230,16,1:00PM,Houston Texans_2022,Tennessee Titans_2022,19,14,-5
231,16,1:00PM,Seattle Seahawks_2022,Kansas City Chiefs_2022,10,24,14
232,16,1:00PM,New York Giants_2022,Minnesota Vikings_2022,24,27,3
233,16,4:05PM,Washington Commanders_2022,San Francisco 49ers_2022,20,37,17
234,16,4:25PM,Philadelphia Eagles_2022,Dallas Cowboys_2022,34,40,6
235,16,8:15PM,Las Vegas Raiders_2022,Pittsburgh Steelers_2022,10,13,3
236,16,1:00PM,Green Bay Packers_2022,Miami Dolphins_2022,26,20,-6
237,16,4:30PM,Denver Broncos_2022,Los Angeles Rams_2022,14,51,37
238,16,8:20PM,Tampa Bay Buccaneers_2022,Arizona Cardinals_2022,19,16,-3
239,16,8:15PM,Los Angeles Chargers_2022,Indianapolis Colts_2022,20,3,-17
240,17,8:15PM,Dallas Cowboys_2022,Tennessee Titans_2022,27,13,-14
241,17,1:00PM,Arizona Cardinals_2022,Atlanta Falcons_2022,19,20,1
242,17,1:00PM,Carolina Panthers_2022,Tampa Bay Buccaneers_2022,24,30,6
243,17,1:00PM,Chicago Bears_2022,Detroit Lions_2022,10,41,31
244,17,1:00PM,Cleveland Browns_2022,Washington Commanders_2022,24,10,-14
245,17,1:00PM,Indianapolis Colts_2022,New York Giants_2022,10,38,28
246,17,1:00PM,Denver Broncos_2022,Kansas City Chiefs_2022,24,27,3
247,17,1:00PM,Jacksonville Jaguars_2022,Houston Texans_2022,31,3,-28
248,17,1:00PM,Miami Dolphins_2022,New England Patriots_2022,21,23,2
249,17,1:00PM,New Orleans Saints_2022,Philadelphia Eagles_2022,20,10,-10
250,17,4:05PM,New York Jets_2022,Seattle Seahawks_2022,6,23,17
251,17,4:05PM,San Francisco 49ers_2022,Las Vegas Raiders_2022,37,34,-3
252,17,4:25PM,Minnesota Vikings_2022,Green Bay Packers_2022,17,41,24
253,17,4:25PM,Los Angeles Rams_2022,Los Angeles Chargers_2022,10,31,21
254,17,8:20PM,Pittsburgh Steelers_2022,Baltimore Ravens_2022,16,13,-3
255,18,4:30PM,Kansas City Chiefs_2022,Las Vegas Raiders_2022,31,13,-18
256,18,8:15PM,Tennessee Titans_2022,Jacksonville Jaguars_2022,16,20,4
257,18,1:00PM,New England Patriots_2022,Buffalo Bills_2022,23,35,12
258,18,1:00PM,Baltimore Ravens_2022,Cincinnati Bengals_2022,16,27,11
259,18,1:00PM,Tampa Bay Buccaneers_2022,Atlanta Falcons_2022,17,30,13
260,18,1:00PM,Carolina Panthers_2022,New Orleans Saints_2022,10,7,-3
261,18,1:00PM,Minnesota Vikings_2022,Chicago Bears_2022,29,13,-16
262,18,1:00PM,Cleveland Browns_2022,Pittsburgh Steelers_2022,14,28,14
263,18,1:00PM,Houston Texans_2022,Indianapolis Colts_2022,32,31,-1
264,18,1:00PM,New York Jets_2022,Miami Dolphins_2022,6,11,5
265,18,4:25PM,Arizona Cardinals_2022,San Francisco 49ers_2022,13,38,25
266,18,4:25PM,Dallas Cowboys_2022,Washington Commanders_2022,6,26,20
267,18,4:25PM,Los Angeles Chargers_2022,Denver Broncos_2022,28,31,3
268,18,4:25PM,New York Giants_2022,Philadelphia Eagles_2022,16,22,6
269,18,4:25PM,Los Angeles Rams_2022,Seattle Seahawks_2022,16,19,3
270,18,8:20PM,Detroit Lions_2022,Green Bay Packers_2022,20,16,-4
271,WildCard,4:30PM,Seattle Seahawks_2022,San Francisco 49ers_2022,23,41,18
272,WildCard,8:15PM,Los Angeles Chargers_2022,Jacksonville Jaguars_2022,30,31,1
273,WildCard,1:00PM,Miami Dolphins_2022,Buffalo Bills_2022,31,34,3
274,WildCard,4:30PM,New York Giants_2022,Minnesota Vikings_2022,31,24,-7
275,WildCard,8:15PM,Baltimore Ravens_2022,Cincinnati Bengals_2022,17,24,7
276,WildCard,8:15PM,Dallas Cowboys_2022,Tampa Bay Buccaneers_2022,31,14,-17
277,Division,4:30PM,Jacksonville Jaguars_2022,Kansas City Chiefs_2022,20,27,7
278,Division,8:15PM,New York Giants_2022,Philadelphia Eagles_2022,7,38,31
279,Division,3:00PM,Cincinnati Bengals_2022,Buffalo Bills_2022,27,10,-17
280,Division,6:30PM,Dallas Cowboys_2022,San Francisco 49ers_2022,12,19,7
281,ConfChamp,3:00PM,San Francisco 49ers_2022,Philadelphia Eagles_2022,7,31,24
282,ConfChamp,6:30PM,Cincinnati Bengals_2022,Kansas City Chiefs_2022,20,23,3
283,SuperBowl,6:30PM,Philadelphia Eagles_2022,Kansas City Chiefs_2022,35,38,3
284,1,8:20PM,Dallas Cowboys_2021,Tampa Bay Buccaneers_2021,29,31,2
285,1,1:00PM,Philadelphia Eagles_2021,Atlanta Falcons_2021,32,6,-26
286,1,1:00PM,Pittsburgh Steelers_2021,Buffalo Bills_2021,23,16,-7
287,1,1:00PM,New York Jets_2021,Carolina Panthers_2021,14,19,5
288,1,1:00PM,Minnesota Vikings_2021,Cincinnati Bengals_2021,24,27,3
289,1,1:00PM,Seattle Seahawks_2021,Indianapolis Colts_2021,28,16,-12
290,1,1:00PM,Arizona Cardinals_2021,Tennessee Titans_2021,38,13,-25
291,1,1:00PM,San Francisco 49ers_2021,Detroit Lions_2021,41,33,-8
292,1,1:00PM,Jacksonville Jaguars_2021,Houston Texans_2021,21,37,16
293,1,1:00PM,Los Angeles Chargers_2021,Washington Football Team_2021,20,16,-4
294,1,4:25PM,Cleveland Browns_2021,Kansas City Chiefs_2021,29,33,4
295,1,4:25PM,Denver Broncos_2021,New York Giants_2021,27,13,-14
296,1,4:25PM,Green Bay Packers_2021,New Orleans Saints_2021,3,38,35
297,1,4:25PM,Miami Dolphins_2021,New England Patriots_2021,17,16,-1
298,1,8:20PM,Chicago Bears_2021,Los Angeles Rams_2021,14,34,20
299,1,8:15PM,Baltimore Ravens_2021,Las Vegas Raiders_2021,27,33,6
300,2,8:20PM,New York Giants_2021,Washington Football Team_2021,29,30,1
301,2,1:00PM,Buffalo Bills_2021,Miami Dolphins_2021,35,0,-35
302,2,1:00PM,New Orleans Saints_2021,Carolina Panthers_2021,7,26,19
303,2,1:00PM,Cincinnati Bengals_2021,Chicago Bears_2021,17,20,3
304,2,1:00PM,Houston Texans_2021,Cleveland Browns_2021,21,31,10
305,2,1:00PM,Los Angeles Rams_2021,Indianapolis Colts_2021,27,24,-3
306,2,1:00PM,Denver Broncos_2021,Jacksonville Jaguars_2021,23,13,-10
307,2,1:00PM,New England Patriots_2021,New York Jets_2021,25,6,-19
308,2,1:00PM,San Francisco 49ers_2021,Philadelphia Eagles_2021,17,11,-6
309,2,1:00PM,Las Vegas Raiders_2021,Pittsburgh Steelers_2021,26,17,-9
310,2,4:05PM,Atlanta Falcons_2021,Tampa Bay Buccaneers_2021,25,48,23
311,2,4:05PM,Minnesota Vikings_2021,Arizona Cardinals_2021,33,34,1
312,2,4:25PM,Dallas Cowboys_2021,Los Angeles Chargers_2021,20,17,-3
313,2,4:25PM,Tennessee Titans_2021,Seattle Seahawks_2021,33,30,-3
314,2,8:20PM,Kansas City Chiefs_2021,Baltimore Ravens_2021,35,36,1
315,2,8:15PM,Detroit Lions_2021,Green Bay Packers_2021,17,35,18
316,3,8:20PM,Carolina Panthers_2021,Houston Texans_2021,24,9,-15
317,3,1:00PM,Atlanta Falcons_2021,New York Giants_2021,17,14,-3
318,3,1:00PM,Washington Football Team_2021,Buffalo Bills_2021,21,43,22
319,3,1:00PM,Chicago Bears_2021,Cleveland Browns_2021,6,26,20
320,3,1:00PM,Cincinnati Bengals_2021,Pittsburgh Steelers_2021,24,10,-14
321,3,1:00PM,Indianapolis Colts_2021,Tennessee Titans_2021,16,25,9
322,3,1:00PM,Arizona Cardinals_2021,Jacksonville Jaguars_2021,31,19,-12
323,3,1:00PM,Baltimore Ravens_2021,Detroit Lions_2021,19,17,-2
324,3,1:00PM,Los Angeles Chargers_2021,Kansas City Chiefs_2021,30,24,-6
325,3,1:00PM,New Orleans Saints_2021,New England Patriots_2021,28,13,-15
326,3,4:05PM,New York Jets_2021,Denver Broncos_2021,0,26,26
327,3,4:05PM,Miami Dolphins_2021,Las Vegas Raiders_2021,28,31,3
328,3,4:25PM,Seattle Seahawks_2021,Minnesota Vikings_2021,17,30,13
329,3,4:25PM,Tampa Bay Buccaneers_2021,Los Angeles Rams_2021,24,34,10
330,3,8:20PM,Green Bay Packers_2021,San Francisco 49ers_2021,30,28,-2
331,3,8:15PM,Philadelphia Eagles_2021,Dallas Cowboys_2021,21,41,20
332,4,8:20PM,Jacksonville Jaguars_2021,Cincinnati Bengals_2021,21,24,3
333,4,1:00PM,Washington Football Team_2021,Atlanta Falcons_2021,34,30,-4
334,4,1:00PM,Houston Texans_2021,Buffalo Bills_2021,0,40,40
335,4,1:00PM,Carolina Panthers_2021,Dallas Cowboys_2021,28,36,8
336,4,1:00PM,Detroit Lions_2021,Chicago Bears_2021,14,24,10
337,4,1:00PM,Cleveland Browns_2021,Minnesota Vikings_2021,14,7,-7
338,4,1:00PM,Indianapolis Colts_2021,Miami Dolphins_2021,27,17,-10
339,4,1:00PM,Kansas City Chiefs_2021,Philadelphia Eagles_2021,42,30,-12
340,4,1:00PM,New York Giants_2021,New Orleans Saints_2021,27,21,-6
341,4,1:00PM,Tennessee Titans_2021,New York Jets_2021,24,27,3
342,4,4:05PM,Arizona Cardinals_2021,Los Angeles Rams_2021,37,20,-17
343,4,4:05PM,Seattle Seahawks_2021,San Francisco 49ers_2021,28,21,-7
344,4,4:25PM,Baltimore Ravens_2021,Denver Broncos_2021,23,7,-16
345,4,4:25PM,Pittsburgh Steelers_2021,Green Bay Packers_2021,17,27,10
346,4,8:20PM,Tampa Bay Buccaneers_2021,New England Patriots_2021,19,17,-2
347,4,8:15PM,Las Vegas Raiders_2021,Los Angeles Chargers_2021,14,28,14
348,5,8:20PM,Los Angeles Rams_2021,Seattle Seahawks_2021,26,17,-9
349,5,9:30AM,New York Jets_2021,Atlanta Falcons_2021,20,27,7
350,5,1:00PM,Philadelphia Eagles_2021,Carolina Panthers_2021,21,18,-3
351,5,1:00PM,Green Bay Packers_2021,Cincinnati Bengals_2021,25,22,-3
352,5,1:00PM,Denver Broncos_2021,Pittsburgh Steelers_2021,19,27,8
353,5,1:00PM,Detroit Lions_2021,Minnesota Vikings_2021,17,19,2
354,5,1:00PM,New England Patriots_2021,Houston Texans_2021,25,22,-3
355,5,1:00PM,Tennessee Titans_2021,Jacksonville Jaguars_2021,37,19,-18
356,5,1:00PM,Miami Dolphins_2021,Tampa Bay Buccaneers_2021,17,45,28
357,5,1:00PM,New Orleans Saints_2021,Washington Football Team_2021,33,22,-11
358,5,4:05PM,Chicago Bears_2021,Las Vegas Raiders_2021,20,9,-11
359,5,4:05PM,Cleveland Browns_2021,Los Angeles Chargers_2021,42,47,5
360,5,4:25PM,San Francisco 49ers_2021,Arizona Cardinals_2021,10,17,7
361,5,4:25PM,New York Giants_2021,Dallas Cowboys_2021,20,44,24
362,5,8:20PM,Buffalo Bills_2021,Kansas City Chiefs_2021,38,20,-18
363,5,8:15PM,Indianapolis Colts_2021,Baltimore Ravens_2021,25,31,6
364,6,8:20PM,Tampa Bay Buccaneers_2021,Philadelphia Eagles_2021,28,22,-6
365,6,9:30AM,Miami Dolphins_2021,Jacksonville Jaguars_2021,20,23,3
366,6,1:00PM,Minnesota Vikings_2021,Carolina Panthers_2021,34,28,-6
367,6,1:00PM,Green Bay Packers_2021,Chicago Bears_2021,24,14,-10
368,6,1:00PM,Cincinnati Bengals_2021,Detroit Lions_2021,34,11,-23
369,6,1:00PM,Houston Texans_2021,Indianapolis Colts_2021,3,31,28
370,6,1:00PM,Kansas City Chiefs_2021,Washington Football Team_2021,31,13,-18
371,6,1:00PM,Los Angeles Rams_2021,New York Giants_2021,38,11,-27
372,6,1:00PM,Los Angeles Chargers_2021,Baltimore Ravens_2021,6,34,28
373,6,4:05PM,Arizona Cardinals_2021,Cleveland Browns_2021,37,14,-23
374,6,4:25PM,Dallas Cowboys_2021,New England Patriots_2021,35,29,-6
375,6,4:25PM,Las Vegas Raiders_2021,Denver Broncos_2021,34,24,-10
376,6,8:20PM,Seattle Seahawks_2021,Pittsburgh Steelers_2021,20,23,3
377,6,8:15PM,Buffalo Bills_2021,Tennessee Titans_2021,31,34,3
378,7,8:20PM,Denver Broncos_2021,Cleveland Browns_2021,14,17,3
379,7,1:00PM,Atlanta Falcons_2021,Miami Dolphins_2021,30,28,-2
380,7,1:00PM,Carolina Panthers_2021,New York Giants_2021,3,25,22
381,7,1:00PM,Cincinnati Bengals_2021,Baltimore Ravens_2021,41,17,-24
382,7,1:00PM,Washington Football Team_2021,Green Bay Packers_2021,10,24,14
383,7,1:00PM,Kansas City Chiefs_2021,Tennessee Titans_2021,3,27,24
384,7,1:00PM,New York Jets_2021,New England Patriots_2021,13,54,41
385,7,4:05PM,Detroit Lions_2021,Los Angeles Rams_2021,19,28,9
386,7,4:05PM,Philadelphia Eagles_2021,Las Vegas Raiders_2021,22,33,11
387,7,4:25PM,Chicago Bears_2021,Tampa Bay Buccaneers_2021,3,38,35
388,7,4:25PM,Houston Texans_2021,Arizona Cardinals_2021,5,31,26
389,7,8:20PM,Indianapolis Colts_2021,San Francisco 49ers_2021,30,18,-12
390,7,8:15PM,New Orleans Saints_2021,Seattle Seahawks_2021,13,10,-3
391,8,8:20PM,Green Bay Packers_2021,Arizona Cardinals_2021,24,21,-3
392,8,1:00PM,Carolina Panthers_2021,Atlanta Falcons_2021,19,13,-6
393,8,1:00PM,Miami Dolphins_2021,Buffalo Bills_2021,11,26,15
394,8,1:00PM,San Francisco 49ers_2021,Chicago Bears_2021,33,22,-11
395,8,1:00PM,Cincinnati Bengals_2021,New York Jets_2021,31,34,3
396,8,1:00PM,Pittsburgh Steelers_2021,Cleveland Browns_2021,15,10,-5
397,8,1:00PM,Tennessee Titans_2021,Indianapolis Colts_2021,34,31,-3
398,8,1:00PM,Philadelphia Eagles_2021,Detroit Lions_2021,44,6,-38
399,8,1:00PM,Los Angeles Rams_2021,Houston Texans_2021,38,22,-16
400,8,4:05PM,Jacksonville Jaguars_2021,Seattle Seahawks_2021,7,31,24
401,8,4:05PM,New England Patriots_2021,Los Angeles Chargers_2021,27,24,-3
402,8,4:25PM,Tampa Bay Buccaneers_2021,New Orleans Saints_2021,27,36,9
403,8,4:25PM,Washington Football Team_2021,Denver Broncos_2021,10,17,7
404,8,8:20PM,Dallas Cowboys_2021,Minnesota Vikings_2021,20,16,-4
405,8,8:15PM,New York Giants_2021,Kansas City Chiefs_2021,17,20,3
406,9,8:20PM,New York Jets_2021,Indianapolis Colts_2021,30,45,15
407,9,1:00PM,Atlanta Falcons_2021,New Orleans Saints_2021,27,25,-2
408,9,1:00PM,Buffalo Bills_2021,Jacksonville Jaguars_2021,6,9,3
409,9,1:00PM,Denver Broncos_2021,Dallas Cowboys_2021,30,16,-14
410,9,1:00PM,Minnesota Vikings_2021,Baltimore Ravens_2021,31,34,3
411,9,1:00PM,New England Patriots_2021,Carolina Panthers_2021,24,6,-18
412,9,1:00PM,Cleveland Browns_2021,Cincinnati Bengals_2021,41,16,-25
413,9,1:00PM,Houston Texans_2021,Miami Dolphins_2021,9,17,8
414,9,1:00PM,Las Vegas Raiders_2021,New York Giants_2021,16,23,7
415,9,4:05PM,Los Angeles Chargers_2021,Philadelphia Eagles_2021,27,24,-3
416,9,4:25PM,Arizona Cardinals_2021,San Francisco 49ers_2021,31,17,-14
417,9,4:25PM,Green Bay Packers_2021,Kansas City Chiefs_2021,7,13,6
418,9,8:20PM,Tennessee Titans_2021,Los Angeles Rams_2021,28,16,-12
419,9,8:15PM,Chicago Bears_2021,Pittsburgh Steelers_2021,27,29,2
420,10,8:20PM,Baltimore Ravens_2021,Miami Dolphins_2021,10,22,12
421,10,1:00PM,Atlanta Falcons_2021,Dallas Cowboys_2021,3,43,40
422,10,1:00PM,Buffalo Bills_2021,New York Jets_2021,45,17,-28
423,10,1:00PM,Detroit Lions_2021,Pittsburgh Steelers_2021,16,16,0
424,10,1:00PM,New Orleans Saints_2021,Tennessee Titans_2021,21,23,2
425,10,1:00PM,Tampa Bay Buccaneers_2021,Washington Football Team_2021,19,29,10
426,10,1:00PM,Cleveland Browns_2021,New England Patriots_2021,7,45,38
427,10,1:00PM,Jacksonville Jaguars_2021,Indianapolis Colts_2021,17,23,6
428,10,4:05PM,Minnesota Vikings_2021,Los Angeles Chargers_2021,27,20,-7
429,10,4:05PM,Carolina Panthers_2021,Arizona Cardinals_2021,34,10,-24
430,10,4:25PM,Philadelphia Eagles_2021,Denver Broncos_2021,30,13,-17
431,10,4:25PM,Seattle Seahawks_2021,Green Bay Packers_2021,0,17,17
432,10,8:20PM,Kansas City Chiefs_2021,Las Vegas Raiders_2021,41,14,-27
433,10,8:15PM,Los Angeles Rams_2021,San Francisco 49ers_2021,10,31,21
434,11,8:20PM,New England Patriots_2021,Atlanta Falcons_2021,25,0,-25
435,11,1:00PM,Indianapolis Colts_2021,Buffalo Bills_2021,41,15,-26
436,11,1:00PM,Baltimore Ravens_2021,Chicago Bears_2021,16,13,-3
437,11,1:00PM,Houston Texans_2021,Tennessee Titans_2021,22,13,-9
438,11,1:00PM,San Francisco 49ers_2021,Jacksonville Jaguars_2021,30,10,-20
439,11,1:00PM,New Orleans Saints_2021,Philadelphia Eagles_2021,29,40,11
440,11,1:00PM,Washington Football Team_2021,Carolina Panthers_2021,27,21,-6
441,11,1:00PM,Detroit Lions_2021,Cleveland Browns_2021,10,13,3
442,11,1:00PM,Green Bay Packers_2021,Minnesota Vikings_2021,31,34,3
443,11,1:00PM,Miami Dolphins_2021,New York Jets_2021,24,17,-7
444,11,4:05PM,Cincinnati Bengals_2021,Las Vegas Raiders_2021,32,13,-19
445,11,4:25PM,Dallas Cowboys_2021,Kansas City Chiefs_2021,9,19,10
446,11,4:25PM,Arizona Cardinals_2021,Seattle Seahawks_2021,23,13,-10
447,11,8:20PM,Pittsburgh Steelers_2021,Los Angeles Chargers_2021,37,41,4
448,11,8:15PM,New York Giants_2021,Tampa Bay Buccaneers_2021,10,30,20
449,12,12:30PM,Chicago Bears_2021,Detroit Lions_2021,16,14,-2
450,12,4:30PM,Las Vegas Raiders_2021,Dallas Cowboys_2021,36,33,-3
451,12,8:20PM,Buffalo Bills_2021,New Orleans Saints_2021,31,6,-25
452,12,1:00PM,Atlanta Falcons_2021,Jacksonville Jaguars_2021,21,14,-7
453,12,1:00PM,Pittsburgh Steelers_2021,Cincinnati Bengals_2021,10,41,31
454,12,1:00PM,New York Jets_2021,Houston Texans_2021,21,14,-7
455,12,1:00PM,Philadelphia Eagles_2021,New York Giants_2021,7,13,6
456,12,1:00PM,Carolina Panthers_2021,Miami Dolphins_2021,10,33,23
457,12,1:00PM,Tampa Bay Buccaneers_2021,Indianapolis Colts_2021,38,31,-7
458,12,1:00PM,Tennessee Titans_2021,New England Patriots_2021,13,36,23
459,12,4:05PM,Los Angeles Chargers_2021,Denver Broncos_2021,13,28,15
460,12,4:25PM,Minnesota Vikings_2021,San Francisco 49ers_2021,26,34,8
461,12,4:25PM,Los Angeles Rams_2021,Green Bay Packers_2021,28,36,8
462,12,8:20PM,Cleveland Browns_2021,Baltimore Ravens_2021,10,16,6
463,12,8:15PM,Seattle Seahawks_2021,Washington Football Team_2021,15,17,2
464,13,8:20PM,Dallas Cowboys_2021,New Orleans Saints_2021,27,17,-10
465,13,1:00PM,Tampa Bay Buccaneers_2021,Atlanta Falcons_2021,30,17,-13
466,13,1:00PM,Arizona Cardinals_2021,Chicago Bears_2021,33,22,-11
467,13,1:00PM,Los Angeles Chargers_2021,Cincinnati Bengals_2021,41,22,-19
468,13,1:00PM,Minnesota Vikings_2021,Detroit Lions_2021,27,29,2
469,13,1:00PM,Philadelphia Eagles_2021,New York Jets_2021,33,18,-15
470,13,1:00PM,Indianapolis Colts_2021,Houston Texans_2021,31,0,-31
471,13,1:00PM,New York Giants_2021,Miami Dolphins_2021,9,20,11
472,13,4:00PM,San Francisco 49ers_2021,Seattle Seahawks_2021,23,30,7
473,13,4:05PM,Washington Football Team_2021,Las Vegas Raiders_2021,17,15,-2
474,13,4:25PM,Jacksonville Jaguars_2021,Los Angeles Rams_2021,7,37,30
475,13,4:25PM,Baltimore Ravens_2021,Pittsburgh Steelers_2021,19,20,1
476,13,8:20PM,Denver Broncos_2021,Kansas City Chiefs_2021,9,22,13
477,13,8:15PM,New England Patriots_2021,Buffalo Bills_2021,14,10,-4
478,14,8:20PM,Pittsburgh Steelers_2021,Minnesota Vikings_2021,28,36,8
479,14,1:00PM,Atlanta Falcons_2021,Carolina Panthers_2021,29,21,-8
480,14,1:00PM,San Francisco 49ers_2021,Cincinnati Bengals_2021,26,23,-3
481,14,1:00PM,Baltimore Ravens_2021,Cleveland Browns_2021,22,24,2
482,14,1:00PM,Dallas Cowboys_2021,Washington Football Team_2021,27,20,-7
483,14,1:00PM,Seattle Seahawks_2021,Houston Texans_2021,33,13,-20
484,14,1:00PM,Jacksonville Jaguars_2021,Tennessee Titans_2021,0,20,20
485,14,1:00PM,Las Vegas Raiders_2021,Kansas City Chiefs_2021,9,48,39
486,14,1:00PM,New Orleans Saints_2021,New York Jets_2021,30,9,-21
487,14,4:05PM,Detroit Lions_2021,Denver Broncos_2021,10,38,28
488,14,4:05PM,New York Giants_2021,Los Angeles Chargers_2021,21,37,16
489,14,4:25PM,Buffalo Bills_2021,Tampa Bay Buccaneers_2021,27,33,6
490,14,8:20PM,Chicago Bears_2021,Green Bay Packers_2021,30,45,15
491,14,8:15PM,Los Angeles Rams_2021,Arizona Cardinals_2021,30,23,-7
492,15,8:20PM,Kansas City Chiefs_2021,Los Angeles Chargers_2021,34,28,-6
493,15,8:20PM,New England Patriots_2021,Indianapolis Colts_2021,17,27,10
494,15,1:00PM,Carolina Panthers_2021,Buffalo Bills_2021,14,31,17
495,15,1:00PM,Arizona Cardinals_2021,Detroit Lions_2021,12,30,18
496,15,1:00PM,Dallas Cowboys_2021,New York Giants_2021,21,6,-15
497,15,1:00PM,Green Bay Packers_2021,Baltimore Ravens_2021,31,30,-1
498,15,1:00PM,Houston Texans_2021,Jacksonville Jaguars_2021,30,16,-14
499,15,1:00PM,New York Jets_2021,Miami Dolphins_2021,24,31,7
500,15,1:00PM,Tennessee Titans_2021,Pittsburgh Steelers_2021,13,19,6
501,15,4:05PM,Atlanta Falcons_2021,San Francisco 49ers_2021,13,31,18
502,15,4:05PM,Cincinnati Bengals_2021,Denver Broncos_2021,15,10,-5
503,15,8:20PM,New Orleans Saints_2021,Tampa Bay Buccaneers_2021,9,0,-9
504,15,5:00PM,Las Vegas Raiders_2021,Cleveland Browns_2021,16,14,-2
505,15,8:15PM,Minnesota Vikings_2021,Chicago Bears_2021,17,9,-8
506,15,7:00PM,Washington Football Team_2021,Philadelphia Eagles_2021,17,27,10
507,15,7:00PM,Seattle Seahawks_2021,Los Angeles Rams_2021,10,20,10
508,16,8:20PM,San Francisco 49ers_2021,Tennessee Titans_2021,17,20,3
509,16,4:30PM,Cleveland Browns_2021,Green Bay Packers_2021,22,24,2
510,16,8:15PM,Indianapolis Colts_2021,Arizona Cardinals_2021,22,16,-6
511,16,1:00PM,Detroit Lions_2021,Atlanta Falcons_2021,16,20,4
512,16,1:00PM,Buffalo Bills_2021,New England Patriots_2021,33,21,-12
513,16,1:00PM,Tampa Bay Buccaneers_2021,Carolina Panthers_2021,32,6,-26
514,16,1:00PM,Baltimore Ravens_2021,Cincinnati Bengals_2021,21,41,20
515,16,1:00PM,Los Angeles Chargers_2021,Houston Texans_2021,29,41,12
516,16,1:00PM,Jacksonville Jaguars_2021,New York Jets_2021,21,26,5
517,16,1:00PM,Los Angeles Rams_2021,Minnesota Vikings_2021,30,23,-7
518,16,1:00PM,New York Giants_2021,Philadelphia Eagles_2021,10,34,24
519,16,4:05PM,Chicago Bears_2021,Seattle Seahawks_2021,25,24,-1
520,16,4:25PM,Denver Broncos_2021,Las Vegas Raiders_2021,13,17,4
521,16,4:25PM,Pittsburgh Steelers_2021,Kansas City Chiefs_2021,10,36,26
522,16,8:20PM,Washington Football Team_2021,Dallas Cowboys_2021,14,56,42
523,16,8:15PM,Miami Dolphins_2021,New Orleans Saints_2021,20,3,-17
524,17,1:00PM,Atlanta Falcons_2021,Buffalo Bills_2021,15,29,14
525,17,1:00PM,Carolina Panthers_2021,New Orleans Saints_2021,10,18,8
526,17,1:00PM,New York Giants_2021,Chicago Bears_2021,3,29,26
527,17,1:00PM,Kansas City Chiefs_2021,Cincinnati Bengals_2021,31,34,3
528,17,1:00PM,Las Vegas Raiders_2021,Indianapolis Colts_2021,23,20,-3
529,17,1:00PM,Arizona Cardinals_2021,Dallas Cowboys_2021,25,22,-3
530,17,1:00PM,Jacksonville Jaguars_2021,New England Patriots_2021,10,50,40
531,17,1:00PM,Miami Dolphins_2021,Tennessee Titans_2021,3,34,31
532,17,1:00PM,Tampa Bay Buccaneers_2021,New York Jets_2021,28,24,-4
533,17,1:00PM,Philadelphia Eagles_2021,Washington Football Team_2021,20,16,-4
534,17,4:05PM,Denver Broncos_2021,Los Angeles Chargers_2021,13,34,21
535,17,4:05PM,Houston Texans_2021,San Francisco 49ers_2021,7,23,16
536,17,4:25PM,Detroit Lions_2021,Seattle Seahawks_2021,29,51,22
537,17,4:25PM,Los Angeles Rams_2021,Baltimore Ravens_2021,20,19,-1
538,17,8:20PM,Minnesota Vikings_2021,Green Bay Packers_2021,10,37,27
539,17,8:15PM,Cleveland Browns_2021,Pittsburgh Steelers_2021,14,26,12
540,18,4:30PM,Kansas City Chiefs_2021,Denver Broncos_2021,28,24,-4
541,18,8:15PM,Dallas Cowboys_2021,Philadelphia Eagles_2021,51,26,-25
542,18,1:00PM,New Orleans Saints_2021,Atlanta Falcons_2021,30,20,-10
543,18,1:00PM,Carolina Panthers_2021,Tampa Bay Buccaneers_2021,17,41,24
544,18,1:00PM,Chicago Bears_2021,Minnesota Vikings_2021,17,31,14
545,18,1:00PM,Cincinnati Bengals_2021,Cleveland Browns_2021,16,21,5
546,18,1:00PM,Indianapolis Colts_2021,Jacksonville Jaguars_2021,11,26,15
547,18,1:00PM,Green Bay Packers_2021,Detroit Lions_2021,30,37,7
548,18,1:00PM,Tennessee Titans_2021,Houston Texans_2021,28,25,-3
549,18,1:00PM,New England Patriots_2021,Miami Dolphins_2021,24,33,9
550,18,1:00PM,Washington Football Team_2021,New York Giants_2021,22,7,-15
551,18,1:00PM,Pittsburgh Steelers_2021,Baltimore Ravens_2021,16,13,-3
552,18,4:25PM,New York Jets_2021,Buffalo Bills_2021,10,27,17
553,18,4:25PM,Seattle Seahawks_2021,Arizona Cardinals_2021,38,30,-8
554,18,4:25PM,San Francisco 49ers_2021,Los Angeles Rams_2021,27,24,-3
555,18,8:25PM,Los Angeles Chargers_2021,Las Vegas Raiders_2021,32,35,3
556,WildCard,4:30PM,Las Vegas Raiders_2021,Cincinnati Bengals_2021,19,26,7
557,WildCard,8:15PM,New England Patriots_2021,Buffalo Bills_2021,17,47,30
558,WildCard,1:00PM,Philadelphia Eagles_2021,Tampa Bay Buccaneers_2021,15,31,16
559,WildCard,4:40PM,San Francisco 49ers_2021,Dallas Cowboys_2021,23,17,-6
560,WildCard,8:15PM,Pittsburgh Steelers_2021,Kansas City Chiefs_2021,21,42,21
561,WildCard,8:15PM,Arizona Cardinals_2021,Los Angeles Rams_2021,11,34,23
562,Division,4:30PM,Cincinnati Bengals_2021,Tennessee Titans_2021,19,16,-3
563,Division,8:15PM,San Francisco 49ers_2021,Green Bay Packers_2021,13,10,-3
564,Division,3:00PM,Los Angeles Rams_2021,Tampa Bay Buccaneers_2021,30,27,-3
565,Division,6:30PM,Buffalo Bills_2021,Kansas City Chiefs_2021,36,42,6
566,ConfChamp,3:00PM,Cincinnati Bengals_2021,Kansas City Chiefs_2021,27,24,-3
567,ConfChamp,6:30PM,San Francisco 49ers_2021,Los Angeles Rams_2021,17,20,3
568,SuperBowl,6:30PM,Cincinnati Bengals_2021,Los Angeles Rams_2021,20,23,3
569,1,8:20PM,Houston Texans_2020,Kansas City Chiefs_2020,20,34,14
570,1,1:00PM,Seattle Seahawks_2020,Atlanta Falcons_2020,38,25,-13
571,1,1:00PM,New York Jets_2020,Buffalo Bills_2020,17,27,10
572,1,1:00PM,Las Vegas Raiders_2020,Carolina Panthers_2020,34,30,-4
573,1,1:00PM,Chicago Bears_2020,Detroit Lions_2020,27,23,-4
574,1,1:00PM,Cleveland Browns_2020,Baltimore Ravens_2020,6,38,32
575,1,1:00PM,Indianapolis Colts_2020,Jacksonville Jaguars_2020,20,27,7
576,1,1:00PM,Green Bay Packers_2020,Minnesota Vikings_2020,43,34,-9
577,1,1:00PM,Miami Dolphins_2020,New England Patriots_2020,11,21,10
578,1,1:00PM,Philadelphia Eagles_2020,Washington Football Team_2020,17,27,10
579,1,4:05PM,Los Angeles Chargers_2020,Cincinnati Bengals_2020,16,13,-3
580,1,4:25PM,Arizona Cardinals_2020,San Francisco 49ers_2020,24,20,-4
581,1,4:25PM,Tampa Bay Buccaneers_2020,New Orleans Saints_2020,23,34,11
582,1,8:20PM,Dallas Cowboys_2020,Los Angeles Rams_2020,17,20,3
583,1,7:15PM,Pittsburgh Steelers_2020,New York Giants_2020,26,16,-10
584,1,10:10PM,Tennessee Titans_2020,Denver Broncos_2020,16,14,-2
585,2,8:20PM,Cincinnati Bengals_2020,Cleveland Browns_2020,30,35,5
586,2,1:00PM,Atlanta Falcons_2020,Dallas Cowboys_2020,39,40,1
587,2,1:00PM,Buffalo Bills_2020,Miami Dolphins_2020,31,28,-3
588,2,1:00PM,Carolina Panthers_2020,Tampa Bay Buccaneers_2020,17,31,14
589,2,1:00PM,New York Giants_2020,Chicago Bears_2020,13,17,4
590,2,1:00PM,Minnesota Vikings_2020,Indianapolis Colts_2020,11,28,17
591,2,1:00PM,Denver Broncos_2020,Pittsburgh Steelers_2020,21,26,5
592,2,1:00PM,Detroit Lions_2020,Green Bay Packers_2020,21,42,21
593,2,1:00PM,Jacksonville Jaguars_2020,Tennessee Titans_2020,30,33,3
594,2,1:00PM,San Francisco 49ers_2020,New York Jets_2020,31,13,-18
595,2,1:00PM,Los Angeles Rams_2020,Philadelphia Eagles_2020,37,19,-18
596,2,4:05PM,Washington Football Team_2020,Arizona Cardinals_2020,15,30,15
597,2,4:25PM,Baltimore Ravens_2020,Houston Texans_2020,33,16,-17
598,2,4:25PM,Kansas City Chiefs_2020,Los Angeles Chargers_2020,23,20,-3
599,2,8:20PM,New England Patriots_2020,Seattle Seahawks_2020,30,35,5
600,2,8:15PM,New Orleans Saints_2020,Las Vegas Raiders_2020,24,34,10
601,3,8:20PM,Miami Dolphins_2020,Jacksonville Jaguars_2020,31,13,-18
602,3,1:00PM,Chicago Bears_2020,Atlanta Falcons_2020,30,26,-4
603,3,1:00PM,Los Angeles Rams_2020,Buffalo Bills_2020,32,35,3
604,3,1:00PM,Cincinnati Bengals_2020,Philadelphia Eagles_2020,23,23,0
605,3,1:00PM,Washington Football Team_2020,Cleveland Browns_2020,20,34,14
606,3,1:00PM,Houston Texans_2020,Pittsburgh Steelers_2020,21,28,7
607,3,1:00PM,Tennessee Titans_2020,Minnesota Vikings_2020,31,30,-1
608,3,1:00PM,Las Vegas Raiders_2020,New England Patriots_2020,20,36,16
609,3,1:00PM,San Francisco 49ers_2020,New York Giants_2020,36,9,-27
610,3,4:05PM,Carolina Panthers_2020,Los Angeles Chargers_2020,21,16,-5
611,3,4:05PM,New York Jets_2020,Indianapolis Colts_2020,7,36,29
612,3,4:25PM,Detroit Lions_2020,Arizona Cardinals_2020,26,23,-3
613,3,4:25PM,Dallas Cowboys_2020,Seattle Seahawks_2020,31,38,7
614,3,4:25PM,Tampa Bay Buccaneers_2020,Denver Broncos_2020,28,10,-18
615,3,8:20PM,Green Bay Packers_2020,New Orleans Saints_2020,37,30,-7
616,3,8:15PM,Kansas City Chiefs_2020,Baltimore Ravens_2020,34,20,-14
617,4,8:20PM,Denver Broncos_2020,New York Jets_2020,37,28,-9
618,4,1:00PM,Arizona Cardinals_2020,Carolina Panthers_2020,21,31,10
619,4,1:00PM,Indianapolis Colts_2020,Chicago Bears_2020,19,11,-8
620,4,1:00PM,Jacksonville Jaguars_2020,Cincinnati Bengals_2020,25,33,8
621,4,1:00PM,Cleveland Browns_2020,Dallas Cowboys_2020,49,38,-11
622,4,1:00PM,New Orleans Saints_2020,Detroit Lions_2020,35,29,-6
623,4,1:00PM,Minnesota Vikings_2020,Houston Texans_2020,31,23,-8
624,4,1:00PM,Seattle Seahawks_2020,Miami Dolphins_2020,31,23,-8
625,4,1:00PM,Baltimore Ravens_2020,Washington Football Team_2020,31,17,-14
626,4,1:00PM,Los Angeles Chargers_2020,Tampa Bay Buccaneers_2020,31,38,7
627,4,4:05PM,New York Giants_2020,Los Angeles Rams_2020,9,17,8
628,4,4:25PM,Buffalo Bills_2020,Las Vegas Raiders_2020,30,23,-7
629,4,8:20PM,Philadelphia Eagles_2020,San Francisco 49ers_2020,25,20,-5
630,4,7:05PM,New England Patriots_2020,Kansas City Chiefs_2020,10,26,16
631,4,8:15PM,Atlanta Falcons_2020,Green Bay Packers_2020,16,30,14
632,5,8:20PM,Tampa Bay Buccaneers_2020,Chicago Bears_2020,19,20,1
633,5,1:00PM,Carolina Panthers_2020,Atlanta Falcons_2020,23,16,-7
634,5,1:00PM,Cincinnati Bengals_2020,Baltimore Ravens_2020,3,27,24
635,5,1:00PM,Arizona Cardinals_2020,New York Jets_2020,30,10,-20
636,5,1:00PM,Jacksonville Jaguars_2020,Houston Texans_2020,14,30,16
637,5,1:00PM,Las Vegas Raiders_2020,Kansas City Chiefs_2020,40,32,-8
638,5,1:00PM,Philadelphia Eagles_2020,Pittsburgh Steelers_2020,29,38,9
639,5,1:00PM,Los Angeles Rams_2020,Washington Football Team_2020,30,10,-20
640,5,4:05PM,Miami Dolphins_2020,San Francisco 49ers_2020,43,17,-26
641,5,4:25PM,Indianapolis Colts_2020,Cleveland Browns_2020,23,32,9
642,5,4:25PM,New York Giants_2020,Dallas Cowboys_2020,34,37,3
643,5,8:20PM,Minnesota Vikings_2020,Seattle Seahawks_2020,26,27,1
644,5,8:15PM,Los Angeles Chargers_2020,New Orleans Saints_2020,27,30,3
645,5,7:00PM,Buffalo Bills_2020,Tennessee Titans_2020,16,42,26
646,6,1:00PM,Denver Broncos_2020,New England Patriots_2020,18,12,-6
647,6,1:00PM,Detroit Lions_2020,Jacksonville Jaguars_2020,34,16,-18
648,6,1:00PM,Atlanta Falcons_2020,Minnesota Vikings_2020,40,23,-17
649,6,1:00PM,Chicago Bears_2020,Carolina Panthers_2020,23,16,-7
650,6,1:00PM,Cincinnati Bengals_2020,Indianapolis Colts_2020,27,31,4
651,6,1:00PM,Cleveland Browns_2020,Pittsburgh Steelers_2020,7,38,31
652,6,1:00PM,Houston Texans_2020,Tennessee Titans_2020,36,42,6
653,6,1:00PM,Washington Football Team_2020,New York Giants_2020,19,20,1
654,6,1:00PM,Baltimore Ravens_2020,Philadelphia Eagles_2020,30,28,-2
655,6,4:05PM,New York Jets_2020,Miami Dolphins_2020,0,24,24
656,6,4:25PM,Green Bay Packers_2020,Tampa Bay Buccaneers_2020,10,38,28
657,6,8:20PM,Los Angeles Rams_2020,San Francisco 49ers_2020,16,24,8
658,6,5:00PM,Kansas City Chiefs_2020,Buffalo Bills_2020,26,17,-9
659,6,8:15PM,Arizona Cardinals_2020,Dallas Cowboys_2020,38,10,-28
660,7,8:20PM,New York Giants_2020,Philadelphia Eagles_2020,21,22,1
661,7,1:00PM,Green Bay Packers_2020,Houston Texans_2020,35,20,-15
662,7,1:00PM,Pittsburgh Steelers_2020,Tennessee Titans_2020,27,24,-3
663,7,1:00PM,Detroit Lions_2020,Atlanta Falcons_2020,23,22,-1
664,7,1:00PM,Buffalo Bills_2020,New York Jets_2020,18,10,-8
665,7,1:00PM,Carolina Panthers_2020,New Orleans Saints_2020,24,27,3
666,7,1:00PM,Cleveland Browns_2020,Cincinnati Bengals_2020,37,34,-3
667,7,1:00PM,Dallas Cowboys_2020,Washington Football Team_2020,3,25,22
668,7,4:05PM,Tampa Bay Buccaneers_2020,Las Vegas Raiders_2020,45,20,-25
669,7,4:25PM,Kansas City Chiefs_2020,Denver Broncos_2020,43,16,-27
670,7,4:25PM,San Francisco 49ers_2020,New England Patriots_2020,33,6,-27
671,7,4:25PM,Jacksonville Jaguars_2020,Los Angeles Chargers_2020,29,39,10
672,7,8:20PM,Seattle Seahawks_2020,Arizona Cardinals_2020,34,37,3
673,7,8:15PM,Chicago Bears_2020,Los Angeles Rams_2020,10,24,14
674,8,8:20PM,Atlanta Falcons_2020,Carolina Panthers_2020,25,17,-8
675,8,1:00PM,Indianapolis Colts_2020,Detroit Lions_2020,41,21,-20
676,8,1:00PM,Minnesota Vikings_2020,Green Bay Packers_2020,28,22,-6
677,8,1:00PM,Los Angeles Rams_2020,Miami Dolphins_2020,17,28,11
678,8,1:00PM,Pittsburgh Steelers_2020,Baltimore Ravens_2020,28,24,-4
679,8,1:00PM,New England Patriots_2020,Buffalo Bills_2020,21,24,3
680,8,1:00PM,Tennessee Titans_2020,Cincinnati Bengals_2020,20,31,11
681,8,1:00PM,Las Vegas Raiders_2020,Cleveland Browns_2020,16,6,-10
682,8,1:00PM,New York Jets_2020,Kansas City Chiefs_2020,9,35,26
683,8,4:05PM,Los Angeles Chargers_2020,Denver Broncos_2020,30,31,1
684,8,4:25PM,San Francisco 49ers_2020,Seattle Seahawks_2020,27,37,10
685,8,4:25PM,New Orleans Saints_2020,Chicago Bears_2020,26,23,-3
686,8,8:20PM,Dallas Cowboys_2020,Philadelphia Eagles_2020,9,23,14
687,8,8:15PM,Tampa Bay Buccaneers_2020,New York Giants_2020,25,23,-2
688,9,8:20PM,Green Bay Packers_2020,San Francisco 49ers_2020,34,17,-17
689,9,1:00PM,Baltimore Ravens_2020,Indianapolis Colts_2020,24,10,-14
690,9,1:00PM,Detroit Lions_2020,Minnesota Vikings_2020,20,34,14
691,9,1:00PM,Houston Texans_2020,Jacksonville Jaguars_2020,27,25,-2
692,9,1:00PM,Denver Broncos_2020,Atlanta Falcons_2020,27,34,7
693,9,1:00PM,Seattle Seahawks_2020,Buffalo Bills_2020,34,44,10
694,9,1:00PM,Carolina Panthers_2020,Kansas City Chiefs_2020,31,33,2
695,9,1:00PM,Chicago Bears_2020,Tennessee Titans_2020,17,24,7
696,9,1:00PM,New York Giants_2020,Washington Football Team_2020,23,20,-3
697,9,4:05PM,Las Vegas Raiders_2020,Los Angeles Chargers_2020,31,26,-5
698,9,4:25PM,Miami Dolphins_2020,Arizona Cardinals_2020,34,31,-3
699,9,4:25PM,Pittsburgh Steelers_2020,Dallas Cowboys_2020,24,19,-5
700,9,8:20PM,New Orleans Saints_2020,Tampa Bay Buccaneers_2020,38,3,-35
701,9,8:15PM,New England Patriots_2020,New York Jets_2020,30,27,-3
702,10,8:20PM,Indianapolis Colts_2020,Tennessee Titans_2020,34,17,-17
703,10,1:00PM,Houston Texans_2020,Cleveland Browns_2020,7,10,3
704,10,1:00PM,Washington Football Team_2020,Detroit Lions_2020,27,30,3
705,10,1:00PM,Jacksonville Jaguars_2020,Green Bay Packers_2020,20,24,4
706,10,1:00PM,Tampa Bay Buccaneers_2020,Carolina Panthers_2020,46,23,-23
707,10,1:00PM,Philadelphia Eagles_2020,New York Giants_2020,17,27,10
708,10,4:05PM,Denver Broncos_2020,Las Vegas Raiders_2020,12,37,25
709,10,4:05PM,Los Angeles Chargers_2020,Miami Dolphins_2020,21,29,8
710,10,4:05PM,Buffalo Bills_2020,Arizona Cardinals_2020,30,32,2
711,10,4:25PM,Cincinnati Bengals_2020,Pittsburgh Steelers_2020,10,36,26
712,10,4:25PM,San Francisco 49ers_2020,New Orleans Saints_2020,13,27,14
713,10,4:25PM,Seattle Seahawks_2020,Los Angeles Rams_2020,16,23,7
714,10,8:20PM,Baltimore Ravens_2020,New England Patriots_2020,17,23,6
715,10,8:15PM,Minnesota Vikings_2020,Chicago Bears_2020,19,13,-6
716,11,8:20PM,Arizona Cardinals_2020,Seattle Seahawks_2020,21,28,7
717,11,1:00PM,Atlanta Falcons_2020,New Orleans Saints_2020,9,24,15
718,11,1:00PM,Cincinnati Bengals_2020,Washington Football Team_2020,9,20,11
719,11,1:00PM,Philadelphia Eagles_2020,Cleveland Browns_2020,17,22,5
720,11,1:00PM,New England Patriots_2020,Houston Texans_2020,20,27,7
721,11,1:00PM,Pittsburgh Steelers_2020,Jacksonville Jaguars_2020,27,3,-24
722,11,1:00PM,Tennessee Titans_2020,Baltimore Ravens_2020,30,24,-6
723,11,1:00PM,Detroit Lions_2020,Carolina Panthers_2020,0,20,20
724,11,4:05PM,Miami Dolphins_2020,Denver Broncos_2020,13,20,7
725,11,4:05PM,New York Jets_2020,Los Angeles Chargers_2020,28,34,6
726,11,4:25PM,Green Bay Packers_2020,Indianapolis Colts_2020,31,34,3
727,11,4:25PM,Dallas Cowboys_2020,Minnesota Vikings_2020,31,28,-3
728,11,8:20PM,Kansas City Chiefs_2020,Las Vegas Raiders_2020,35,31,-4
729,11,8:15PM,Los Angeles Rams_2020,Tampa Bay Buccaneers_2020,27,24,-3
730,12,12:30PM,Houston Texans_2020,Detroit Lions_2020,41,25,-16
731,12,4:30PM,Washington Football Team_2020,Dallas Cowboys_2020,41,16,-25
732,12,1:00PM,Las Vegas Raiders_2020,Atlanta Falcons_2020,6,43,37
733,12,1:00PM,Los Angeles Chargers_2020,Buffalo Bills_2020,17,27,10
734,12,1:00PM,New York Giants_2020,Cincinnati Bengals_2020,19,17,-2
735,12,1:00PM,Cleveland Browns_2020,Jacksonville Jaguars_2020,27,25,-2
736,12,1:00PM,Tennessee Titans_2020,Indianapolis Colts_2020,45,26,-19
737,12,1:00PM,Arizona Cardinals_2020,New England Patriots_2020,17,20,3
738,12,1:00PM,Miami Dolphins_2020,New York Jets_2020,20,3,-17
739,12,1:00PM,Carolina Panthers_2020,Minnesota Vikings_2020,27,28,1
740,12,4:05PM,New Orleans Saints_2020,Denver Broncos_2020,31,3,-28
741,12,4:05PM,San Francisco 49ers_2020,Los Angeles Rams_2020,23,20,-3
742,12,4:25PM,Kansas City Chiefs_2020,Tampa Bay Buccaneers_2020,27,24,-3
743,12,8:20PM,Chicago Bears_2020,Green Bay Packers_2020,25,41,16
744,12,8:15PM,Seattle Seahawks_2020,Philadelphia Eagles_2020,23,17,-6
745,12,3:40PM,Baltimore Ravens_2020,Pittsburgh Steelers_2020,14,19,5
746,13,1:00PM,New Orleans Saints_2020,Atlanta Falcons_2020,21,16,-5
747,13,1:00PM,Detroit Lions_2020,Chicago Bears_2020,34,30,-4
748,13,1:00PM,Cincinnati Bengals_2020,Miami Dolphins_2020,7,19,12
749,13,1:00PM,Cleveland Browns_2020,Tennessee Titans_2020,41,35,-6
750,13,1:00PM,Indianapolis Colts_2020,Houston Texans_2020,26,20,-6
751,13,1:00PM,Jacksonville Jaguars_2020,Minnesota Vikings_2020,24,27,3
752,13,1:00PM,Las Vegas Raiders_2020,New York Jets_2020,31,28,-3
753,13,4:05PM,Los Angeles Rams_2020,Arizona Cardinals_2020,38,28,-10
754,13,4:05PM,New York Giants_2020,Seattle Seahawks_2020,17,12,-5
755,13,4:25PM,Philadelphia Eagles_2020,Green Bay Packers_2020,16,30,14
756,13,4:25PM,New England Patriots_2020,Los Angeles Chargers_2020,45,0,-45
757,13,8:20PM,Denver Broncos_2020,Kansas City Chiefs_2020,16,22,6
758,13,5:00PM,Washington Football Team_2020,Pittsburgh Steelers_2020,23,17,-6
759,13,8:15PM,Buffalo Bills_2020,San Francisco 49ers_2020,34,24,-10
760,13,8:05PM,Dallas Cowboys_2020,Baltimore Ravens_2020,17,34,17
761,14,8:20PM,New England Patriots_2020,Los Angeles Rams_2020,3,24,21
762,14,1:00PM,Denver Broncos_2020,Carolina Panthers_2020,32,27,-5
763,14,1:00PM,Houston Texans_2020,Chicago Bears_2020,7,36,29
764,14,1:00PM,Dallas Cowboys_2020,Cincinnati Bengals_2020,30,7,-23
765,14,1:00PM,Arizona Cardinals_2020,New York Giants_2020,26,7,-19
766,14,1:00PM,Tennessee Titans_2020,Jacksonville Jaguars_2020,31,10,-21
767,14,1:00PM,Kansas City Chiefs_2020,Miami Dolphins_2020,33,27,-6
768,14,1:00PM,Minnesota Vikings_2020,Tampa Bay Buccaneers_2020,14,26,12
769,14,4:05PM,Indianapolis Colts_2020,Las Vegas Raiders_2020,44,27,-17
770,14,4:05PM,New York Jets_2020,Seattle Seahawks_2020,3,40,37
771,14,4:25PM,Atlanta Falcons_2020,Los Angeles Chargers_2020,17,20,3
772,14,4:25PM,Green Bay Packers_2020,Detroit Lions_2020,31,24,-7
773,14,4:25PM,New Orleans Saints_2020,Philadelphia Eagles_2020,21,24,3
774,14,4:25PM,Washington Football Team_2020,San Francisco 49ers_2020,23,15,-8
775,14,8:20PM,Pittsburgh Steelers_2020,Buffalo Bills_2020,15,26,11
776,14,8:15PM,Baltimore Ravens_2020,Cleveland Browns_2020,47,42,-5
777,15,8:20PM,Los Angeles Chargers_2020,Las Vegas Raiders_2020,30,27,-3
778,15,4:30PM,Buffalo Bills_2020,Denver Broncos_2020,48,19,-29
779,15,8:15PM,Carolina Panthers_2020,Green Bay Packers_2020,16,24,8
780,15,1:00PM,Tampa Bay Buccaneers_2020,Atlanta Falcons_2020,31,27,-4
781,15,1:00PM,Chicago Bears_2020,Minnesota Vikings_2020,33,27,-6
782,15,1:00PM,Houston Texans_2020,Indianapolis Colts_2020,20,27,7
783,15,1:00PM,San Francisco 49ers_2020,Dallas Cowboys_2020,33,41,8
784,15,1:00PM,Detroit Lions_2020,Tennessee Titans_2020,25,46,21
785,15,1:00PM,Jacksonville Jaguars_2020,Baltimore Ravens_2020,14,40,26
786,15,1:00PM,New England Patriots_2020,Miami Dolphins_2020,12,22,10
787,15,1:00PM,Seattle Seahawks_2020,Washington Football Team_2020,20,15,-5
788,15,4:05PM,Philadelphia Eagles_2020,Arizona Cardinals_2020,26,33,7
789,15,4:05PM,New York Jets_2020,Los Angeles Rams_2020,23,20,-3
790,15,4:25PM,Kansas City Chiefs_2020,New Orleans Saints_2020,32,29,-3
791,15,8:20PM,Cleveland Browns_2020,New York Giants_2020,20,6,-14
792,15,8:15PM,Pittsburgh Steelers_2020,Cincinnati Bengals_2020,17,27,10
793,16,4:30PM,Minnesota Vikings_2020,New Orleans Saints_2020,33,52,19
794,16,1:00PM,Tampa Bay Buccaneers_2020,Detroit Lions_2020,47,7,-40
795,16,4:30PM,San Francisco 49ers_2020,Arizona Cardinals_2020,20,12,-8
796,16,8:15PM,Miami Dolphins_2020,Las Vegas Raiders_2020,26,25,-1
797,16,1:00PM,Atlanta Falcons_2020,Kansas City Chiefs_2020,14,17,3
798,16,1:00PM,Chicago Bears_2020,Jacksonville Jaguars_2020,41,17,-24
799,16,1:00PM,Cincinnati Bengals_2020,Houston Texans_2020,37,31,-6
800,16,1:00PM,Cleveland Browns_2020,New York Jets_2020,16,23,7
801,16,1:00PM,Indianapolis Colts_2020,Pittsburgh Steelers_2020,24,28,4
802,16,1:00PM,New York Giants_2020,Baltimore Ravens_2020,13,27,14
803,16,4:05PM,Carolina Panthers_2020,Washington Football Team_2020,20,13,-7
804,16,4:05PM,Denver Broncos_2020,Los Angeles Chargers_2020,16,19,3
805,16,4:25PM,Philadelphia Eagles_2020,Dallas Cowboys_2020,17,37,20
806,16,4:25PM,Los Angeles Rams_2020,Seattle Seahawks_2020,9,20,11
807,16,8:20PM,Tennessee Titans_2020,Green Bay Packers_2020,14,40,26
808,16,8:15PM,Buffalo Bills_2020,New England Patriots_2020,38,9,-29
809,17,1:00PM,Atlanta Falcons_2020,Tampa Bay Buccaneers_2020,27,44,17
810,17,1:00PM,Miami Dolphins_2020,Buffalo Bills_2020,26,56,30
811,17,1:00PM,Baltimore Ravens_2020,Cincinnati Bengals_2020,38,3,-35
812,17,1:00PM,Pittsburgh Steelers_2020,Cleveland Browns_2020,22,24,2
813,17,1:00PM,Dallas Cowboys_2020,New York Giants_2020,19,23,4
814,17,1:00PM,Minnesota Vikings_2020,Detroit Lions_2020,37,35,-2
815,17,1:00PM,New York Jets_2020,New England Patriots_2020,14,28,14
816,17,4:25PM,New Orleans Saints_2020,Carolina Panthers_2020,33,7,-26
817,17,4:25PM,Green Bay Packers_2020,Chicago Bears_2020,35,16,-19
818,17,4:25PM,Jacksonville Jaguars_2020,Indianapolis Colts_2020,14,28,14
819,17,4:25PM,Arizona Cardinals_2020,Los Angeles Rams_2020,7,18,11
820,17,4:25PM,Las Vegas Raiders_2020,Denver Broncos_2020,32,31,-1
821,17,4:25PM,Tennessee Titans_2020,Houston Texans_2020,41,38,-3
822,17,4:25PM,Los Angeles Chargers_2020,Kansas City Chiefs_2020,38,21,-17
823,17,4:25PM,Seattle Seahawks_2020,San Francisco 49ers_2020,26,23,-3
824,17,8:20PM,Washington Football Team_2020,Philadelphia Eagles_2020,20,14,-6
825,WildCard,1:05PM,Indianapolis Colts_2020,Buffalo Bills_2020,24,27,3
826,WildCard,4:40PM,Los Angeles Rams_2020,Seattle Seahawks_2020,30,20,-10
827,WildCard,8:15PM,Tampa Bay Buccaneers_2020,Washington Football Team_2020,31,23,-8
828,WildCard,1:05PM,Baltimore Ravens_2020,Tennessee Titans_2020,20,13,-7
829,WildCard,4:40PM,Chicago Bears_2020,New Orleans Saints_2020,9,21,12
830,WildCard,8:15PM,Cleveland Browns_2020,Pittsburgh Steelers_2020,48,37,-11
831,Division,4:35PM,Los Angeles Rams_2020,Green Bay Packers_2020,18,32,14
832,Division,8:15PM,Baltimore Ravens_2020,Buffalo Bills_2020,3,17,14
833,Division,3:05PM,Cleveland Browns_2020,Kansas City Chiefs_2020,17,22,5
834,Division,6:40PM,Tampa Bay Buccaneers_2020,New Orleans Saints_2020,30,20,-10
835,ConfChamp,3:05PM,Tampa Bay Buccaneers_2020,Green Bay Packers_2020,31,26,-5
836,ConfChamp,6:40PM,Buffalo Bills_2020,Kansas City Chiefs_2020,24,38,14
837,SuperBowl,6:30PM,Kansas City Chiefs_2020,Tampa Bay Buccaneers_2020,9,31,22
838,1,8:20PM,Green Bay Packers_2019,Chicago Bears_2019,10,3,-7
839,1,1:00PM,Atlanta Falcons_2019,Minnesota Vikings_2019,12,28,16
840,1,1:00PM,Buffalo Bills_2019,New York Jets_2019,17,16,-1
841,1,1:00PM,Los Angeles Rams_2019,Carolina Panthers_2019,30,27,-3
842,1,1:00PM,Tennessee Titans_2019,Cleveland Browns_2019,43,13,-30
843,1,1:00PM,Kansas City Chiefs_2019,Jacksonville Jaguars_2019,40,26,-14
844,1,1:00PM,Baltimore Ravens_2019,Miami Dolphins_2019,59,10,-49
845,1,1:00PM,Washington Redskins_2019,Philadelphia Eagles_2019,27,32,5
846,1,4:05PM,Cincinnati Bengals_2019,Seattle Seahawks_2019,20,21,1
847,1,4:05PM,Indianapolis Colts_2019,Los Angeles Chargers_2019,24,30,6
848,1,4:25PM,Detroit Lions_2019,Arizona Cardinals_2019,27,27,0
849,1,4:25PM,New York Giants_2019,Dallas Cowboys_2019,17,35,18
850,1,4:25PM,San Francisco 49ers_2019,Tampa Bay Buccaneers_2019,31,17,-14
851,1,8:20PM,Pittsburgh Steelers_2019,New England Patriots_2019,3,33,30
852,1,7:10PM,Houston Texans_2019,New Orleans Saints_2019,28,30,2
853,1,10:20PM,Denver Broncos_2019,Oakland Raiders_2019,16,24,8
854,2,8:20PM,Tampa Bay Buccaneers_2019,Carolina Panthers_2019,20,14,-6
855,2,1:00PM,Buffalo Bills_2019,New York Giants_2019,28,14,-14
856,2,1:00PM,San Francisco 49ers_2019,Cincinnati Bengals_2019,41,17,-24
857,2,1:00PM,Indianapolis Colts_2019,Tennessee Titans_2019,19,17,-2
858,2,1:00PM,Arizona Cardinals_2019,Baltimore Ravens_2019,17,23,6
859,2,1:00PM,Dallas Cowboys_2019,Washington Redskins_2019,31,21,-10
860,2,1:00PM,Los Angeles Chargers_2019,Detroit Lions_2019,10,13,3
861,2,1:00PM,Minnesota Vikings_2019,Green Bay Packers_2019,16,21,5
862,2,1:00PM,Jacksonville Jaguars_2019,Houston Texans_2019,12,13,1
863,2,1:00PM,New England Patriots_2019,Miami Dolphins_2019,43,0,-43
864,2,1:00PM,Seattle Seahawks_2019,Pittsburgh Steelers_2019,28,26,-2
865,2,4:05PM,Kansas City Chiefs_2019,Oakland Raiders_2019,28,10,-18
866,2,4:25PM,Chicago Bears_2019,Denver Broncos_2019,16,14,-2
867,2,4:25PM,New Orleans Saints_2019,Los Angeles Rams_2019,9,27,18
868,2,8:20PM,Philadelphia Eagles_2019,Atlanta Falcons_2019,20,24,4
869,2,8:15PM,Cleveland Browns_2019,New York Jets_2019,23,3,-20
870,3,8:20PM,Tennessee Titans_2019,Jacksonville Jaguars_2019,7,20,13
871,3,1:00PM,Atlanta Falcons_2019,Indianapolis Colts_2019,24,27,3
872,3,1:00PM,Cincinnati Bengals_2019,Buffalo Bills_2019,17,21,4
873,3,1:00PM,Miami Dolphins_2019,Dallas Cowboys_2019,6,31,25
874,3,1:00PM,Denver Broncos_2019,Green Bay Packers_2019,16,27,11
875,3,1:00PM,Detroit Lions_2019,Philadelphia Eagles_2019,27,24,-3
876,3,1:00PM,Baltimore Ravens_2019,Kansas City Chiefs_2019,28,33,5
877,3,1:00PM,Oakland Raiders_2019,Minnesota Vikings_2019,14,34,20
878,3,1:00PM,New York Jets_2019,New England Patriots_2019,14,30,16
879,3,4:05PM,Carolina Panthers_2019,Arizona Cardinals_2019,38,20,-18
880,3,4:05PM,New York Giants_2019,Tampa Bay Buccaneers_2019,32,31,-1
881,3,4:25PM,Houston Texans_2019,Los Angeles Chargers_2019,27,20,-7
882,3,4:25PM,New Orleans Saints_2019,Seattle Seahawks_2019,33,27,-6
883,3,4:25PM,Pittsburgh Steelers_2019,San Francisco 49ers_2019,20,24,4
884,3,8:20PM,Los Angeles Rams_2019,Cleveland Browns_2019,20,13,-7
885,3,8:15PM,Chicago Bears_2019,Washington Redskins_2019,31,15,-16
886,4,8:20PM,Philadelphia Eagles_2019,Green Bay Packers_2019,34,27,-7
887,4,1:00PM,Tennessee Titans_2019,Atlanta Falcons_2019,24,10,-14
888,4,1:00PM,New England Patriots_2019,Buffalo Bills_2019,16,10,-6
889,4,1:00PM,Carolina Panthers_2019,Houston Texans_2019,16,10,-6
890,4,1:00PM,Cleveland Browns_2019,Baltimore Ravens_2019,40,25,-15
891,4,1:00PM,Oakland Raiders_2019,Indianapolis Colts_2019,31,24,-7
892,4,1:00PM,Kansas City Chiefs_2019,Detroit Lions_2019,34,30,-4
893,4,1:00PM,Los Angeles Chargers_2019,Miami Dolphins_2019,30,10,-20
894,4,1:00PM,Washington Redskins_2019,New York Giants_2019,3,24,21
895,4,4:05PM,Seattle Seahawks_2019,Arizona Cardinals_2019,27,10,-17
896,4,4:05PM,Tampa Bay Buccaneers_2019,Los Angeles Rams_2019,55,40,-15
897,4,4:25PM,Minnesota Vikings_2019,Chicago Bears_2019,6,16,10
898,4,4:25PM,Jacksonville Jaguars_2019,Denver Broncos_2019,26,24,-2
899,4,8:20PM,Dallas Cowboys_2019,New Orleans Saints_2019,10,12,2
900,4,8:15PM,Cincinnati Bengals_2019,Pittsburgh Steelers_2019,3,27,24
901,5,8:20PM,Los Angeles Rams_2019,Seattle Seahawks_2019,29,30,1
902,5,1:00PM,New York Jets_2019,Philadelphia Eagles_2019,6,31,25
903,5,1:00PM,Atlanta Falcons_2019,Houston Texans_2019,32,53,21
904,5,1:00PM,Buffalo Bills_2019,Tennessee Titans_2019,14,7,-7
905,5,1:00PM,Jacksonville Jaguars_2019,Carolina Panthers_2019,27,34,7
906,5,1:00PM,Chicago Bears_2019,Oakland Raiders_2019,21,24,3
907,5,1:00PM,Arizona Cardinals_2019,Cincinnati Bengals_2019,26,23,-3
908,5,1:00PM,Minnesota Vikings_2019,New York Giants_2019,28,10,-18
909,5,1:00PM,Tampa Bay Buccaneers_2019,New Orleans Saints_2019,24,31,7
910,5,1:00PM,New England Patriots_2019,Washington Redskins_2019,33,7,-26
911,5,1:00PM,Baltimore Ravens_2019,Pittsburgh Steelers_2019,26,23,-3
912,5,4:05PM,Denver Broncos_2019,Los Angeles Chargers_2019,20,13,-7
913,5,4:25PM,Green Bay Packers_2019,Dallas Cowboys_2019,34,24,-10
914,5,8:20PM,Indianapolis Colts_2019,Kansas City Chiefs_2019,19,13,-6
915,5,8:15PM,Cleveland Browns_2019,San Francisco 49ers_2019,3,31,28
916,6,8:20PM,New York Giants_2019,New England Patriots_2019,14,35,21
917,6,9:30AM,Carolina Panthers_2019,Tampa Bay Buccaneers_2019,37,26,-11
918,6,1:00PM,Washington Redskins_2019,Miami Dolphins_2019,17,16,-1
919,6,1:00PM,Cincinnati Bengals_2019,Baltimore Ravens_2019,17,23,6
920,6,1:00PM,Seattle Seahawks_2019,Cleveland Browns_2019,32,28,-4
921,6,1:00PM,Houston Texans_2019,Kansas City Chiefs_2019,31,24,-7
922,6,1:00PM,New Orleans Saints_2019,Jacksonville Jaguars_2019,13,6,-7
923,6,1:00PM,Philadelphia Eagles_2019,Minnesota Vikings_2019,20,38,18
924,6,4:05PM,Atlanta Falcons_2019,Arizona Cardinals_2019,33,34,1
925,6,4:05PM,San Francisco 49ers_2019,Los Angeles Rams_2019,20,7,-13
926,6,4:25PM,Dallas Cowboys_2019,New York Jets_2019,22,24,2
927,6,4:25PM,Tennessee Titans_2019,Denver Broncos_2019,0,16,16
928,6,8:20PM,Pittsburgh Steelers_2019,Los Angeles Chargers_2019,24,17,-7
929,6,8:15PM,Detroit Lions_2019,Green Bay Packers_2019,22,23,1
930,7,8:20PM,Kansas City Chiefs_2019,Denver Broncos_2019,30,6,-24
931,7,1:00PM,Miami Dolphins_2019,Buffalo Bills_2019,21,31,10
932,7,1:00PM,Houston Texans_2019,Indianapolis Colts_2019,23,30,7
933,7,1:00PM,Minnesota Vikings_2019,Detroit Lions_2019,42,30,-12
934,7,1:00PM,San Francisco 49ers_2019,Washington Redskins_2019,9,0,-9
935,7,1:00PM,Los Angeles Rams_2019,Atlanta Falcons_2019,37,10,-27
936,7,1:00PM,Jacksonville Jaguars_2019,Cincinnati Bengals_2019,27,17,-10
937,7,1:00PM,Arizona Cardinals_2019,New York Giants_2019,27,21,-6
938,7,1:00PM,Oakland Raiders_2019,Green Bay Packers_2019,24,42,18
939,7,4:05PM,Los Angeles Chargers_2019,Tennessee Titans_2019,20,23,3
940,7,4:25PM,New Orleans Saints_2019,Chicago Bears_2019,36,25,-11
941,7,4:25PM,Baltimore Ravens_2019,Seattle Seahawks_2019,30,16,-14
942,7,8:20PM,Philadelphia Eagles_2019,Dallas Cowboys_2019,10,37,27
943,7,8:15PM,New England Patriots_2019,New York Jets_2019,33,0,-33
944,8,8:20PM,Washington Redskins_2019,Minnesota Vikings_2019,9,19,10
945,8,1:00PM,Philadelphia Eagles_2019,Buffalo Bills_2019,31,13,-18
946,8,1:00PM,Los Angeles Chargers_2019,Chicago Bears_2019,17,16,-1
947,8,1:00PM,Denver Broncos_2019,Indianapolis Colts_2019,13,15,2
948,8,1:00PM,New York Giants_2019,Detroit Lions_2019,26,31,5
949,8,1:00PM,Seattle Seahawks_2019,Atlanta Falcons_2019,27,20,-7
950,8,1:00PM,Cincinnati Bengals_2019,Los Angeles Rams_2019,10,24,14
951,8,1:00PM,Arizona Cardinals_2019,New Orleans Saints_2019,9,31,22
952,8,1:00PM,New York Jets_2019,Jacksonville Jaguars_2019,15,29,14
953,8,1:00PM,Tampa Bay Buccaneers_2019,Tennessee Titans_2019,23,27,4
954,8,4:05PM,Carolina Panthers_2019,San Francisco 49ers_2019,13,51,38
955,8,4:25PM,Cleveland Browns_2019,New England Patriots_2019,13,27,14
956,8,4:25PM,Oakland Raiders_2019,Houston Texans_2019,24,27,3
957,8,8:20PM,Green Bay Packers_2019,Kansas City Chiefs_2019,31,24,-7
958,8,8:15PM,Miami Dolphins_2019,Pittsburgh Steelers_2019,14,27,13
959,9,8:20PM,San Francisco 49ers_2019,Arizona Cardinals_2019,28,25,-3
960,9,9:30AM,Houston Texans_2019,Jacksonville Jaguars_2019,26,3,-23
961,9,1:00PM,Washington Redskins_2019,Buffalo Bills_2019,9,24,15
962,9,1:00PM,Tennessee Titans_2019,Carolina Panthers_2019,20,30,10
963,9,1:00PM,Chicago Bears_2019,Philadelphia Eagles_2019,14,22,8
964,9,1:00PM,Indianapolis Colts_2019,Pittsburgh Steelers_2019,24,26,2
965,9,1:00PM,New York Jets_2019,Miami Dolphins_2019,18,26,8
966,9,1:00PM,Minnesota Vikings_2019,Kansas City Chiefs_2019,23,26,3
967,9,4:05PM,Detroit Lions_2019,Oakland Raiders_2019,24,31,7
968,9,4:05PM,Tampa Bay Buccaneers_2019,Seattle Seahawks_2019,34,40,6
969,9,4:25PM,Cleveland Browns_2019,Denver Broncos_2019,19,24,5
970,9,4:25PM,Green Bay Packers_2019,Los Angeles Chargers_2019,11,26,15
971,9,8:20PM,New England Patriots_2019,Baltimore Ravens_2019,20,37,17
972,9,8:15PM,Dallas Cowboys_2019,New York Giants_2019,37,18,-19
973,10,8:20PM,Los Angeles Chargers_2019,Oakland Raiders_2019,24,26,2
974,10,1:00PM,Atlanta Falcons_2019,New Orleans Saints_2019,26,9,-17
975,10,1:00PM,Buffalo Bills_2019,Cleveland Browns_2019,16,19,3
976,10,1:00PM,Detroit Lions_2019,Chicago Bears_2019,13,20,7
977,10,1:00PM,Baltimore Ravens_2019,Cincinnati Bengals_2019,49,13,-36
978,10,1:00PM,Arizona Cardinals_2019,Tampa Bay Buccaneers_2019,27,30,3
979,10,1:00PM,Kansas City Chiefs_2019,Tennessee Titans_2019,32,35,3
980,10,1:00PM,New York Giants_2019,New York Jets_2019,27,34,7
981,10,4:05PM,Miami Dolphins_2019,Indianapolis Colts_2019,16,12,-4
982,10,4:25PM,Carolina Panthers_2019,Green Bay Packers_2019,16,24,8
983,10,4:25PM,Los Angeles Rams_2019,Pittsburgh Steelers_2019,12,17,5
984,10,8:20PM,Minnesota Vikings_2019,Dallas Cowboys_2019,28,24,-4
985,10,8:15PM,Seattle Seahawks_2019,San Francisco 49ers_2019,27,24,-3
986,11,8:20PM,Pittsburgh Steelers_2019,Cleveland Browns_2019,7,21,14
987,11,1:00PM,Atlanta Falcons_2019,Carolina Panthers_2019,29,3,-26
988,11,1:00PM,Buffalo Bills_2019,Miami Dolphins_2019,37,20,-17
989,11,1:00PM,Jacksonville Jaguars_2019,Indianapolis Colts_2019,13,33,20
990,11,1:00PM,Dallas Cowboys_2019,Detroit Lions_2019,35,27,-8
991,11,1:00PM,Denver Broncos_2019,Minnesota Vikings_2019,23,27,4
992,11,1:00PM,Houston Texans_2019,Baltimore Ravens_2019,7,41,34
993,11,1:00PM,New Orleans Saints_2019,Tampa Bay Buccaneers_2019,34,17,-17
994,11,1:00PM,New York Jets_2019,Washington Redskins_2019,34,17,-17
995,11,4:05PM,Arizona Cardinals_2019,San Francisco 49ers_2019,26,36,10
996,11,4:25PM,Cincinnati Bengals_2019,Oakland Raiders_2019,10,17,7
997,11,4:25PM,New England Patriots_2019,Philadelphia Eagles_2019,17,10,-7
998,11,8:20PM,Chicago Bears_2019,Los Angeles Rams_2019,7,17,10
999,11,8:15PM,Kansas City Chiefs_2019,Los Angeles Chargers_2019,24,17,-7
1000,12,8:20PM,Indianapolis Colts_2019,Houston Texans_2019,17,20,3
1001,12,1:00PM,Tampa Bay Buccaneers_2019,Atlanta Falcons_2019,35,22,-13
1002,12,1:00PM,Denver Broncos_2019,Buffalo Bills_2019,3,20,17
1003,12,1:00PM,Carolina Panthers_2019,New Orleans Saints_2019,31,34,3
1004,12,1:00PM,New York Giants_2019,Chicago Bears_2019,14,19,5
1005,12,1:00PM,Pittsburgh Steelers_2019,Cincinnati Bengals_2019,16,10,-6
1006,12,1:00PM,Miami Dolphins_2019,Cleveland Browns_2019,24,41,17
1007,12,1:00PM,Detroit Lions_2019,Washington Redskins_2019,16,19,3
1008,12,1:00PM,Oakland Raiders_2019,New York Jets_2019,3,34,31
1009,12,1:00PM,Seattle Seahawks_2019,Philadelphia Eagles_2019,17,9,-8
1010,12,4:05PM,Jacksonville Jaguars_2019,Tennessee Titans_2019,20,42,22
1011,12,4:25PM,Dallas Cowboys_2019,New England Patriots_2019,9,13,4
1012,12,8:20PM,Green Bay Packers_2019,San Francisco 49ers_2019,8,37,29
1013,12,8:15PM,Baltimore Ravens_2019,Los Angeles Rams_2019,45,6,-39
1014,13,12:30PM,Chicago Bears_2019,Detroit Lions_2019,24,20,-4
1015,13,4:30PM,Buffalo Bills_2019,Dallas Cowboys_2019,26,15,-11
1016,13,8:20PM,New Orleans Saints_2019,Atlanta Falcons_2019,26,18,-8
1017,13,1:00PM,Washington Redskins_2019,Carolina Panthers_2019,29,21,-8
1018,13,1:00PM,New York Jets_2019,Cincinnati Bengals_2019,6,22,16
1019,13,1:00PM,Cleveland Browns_2019,Pittsburgh Steelers_2019,13,20,7
1020,13,1:00PM,Tennessee Titans_2019,Indianapolis Colts_2019,31,17,-14
1021,13,1:00PM,Green Bay Packers_2019,New York Giants_2019,31,13,-18
1022,13,1:00PM,Tampa Bay Buccaneers_2019,Jacksonville Jaguars_2019,28,11,-17
1023,13,1:00PM,Philadelphia Eagles_2019,Miami Dolphins_2019,31,37,6
1024,13,1:00PM,San Francisco 49ers_2019,Baltimore Ravens_2019,17,20,3
1025,13,4:05PM,Los Angeles Rams_2019,Arizona Cardinals_2019,34,7,-27
1026,13,4:25PM,Los Angeles Chargers_2019,Denver Broncos_2019,20,23,3
1027,13,4:25PM,Oakland Raiders_2019,Kansas City Chiefs_2019,9,40,31
1028,13,8:20PM,New England Patriots_2019,Houston Texans_2019,22,28,6
1029,13,8:15PM,Minnesota Vikings_2019,Seattle Seahawks_2019,30,37,7
1030,14,8:20PM,Dallas Cowboys_2019,Chicago Bears_2019,24,31,7
1031,14,1:00PM,Carolina Panthers_2019,Atlanta Falcons_2019,20,40,20
1032,14,1:00PM,Baltimore Ravens_2019,Buffalo Bills_2019,24,17,-7
1033,14,1:00PM,Cincinnati Bengals_2019,Cleveland Browns_2019,19,27,8
1034,14,1:00PM,Indianapolis Colts_2019,Tampa Bay Buccaneers_2019,35,38,3
1035,14,1:00PM,Denver Broncos_2019,Houston Texans_2019,38,24,-14
1036,14,1:00PM,Detroit Lions_2019,Minnesota Vikings_2019,7,20,13
1037,14,1:00PM,Washington Redskins_2019,Green Bay Packers_2019,15,20,5
1038,14,1:00PM,Miami Dolphins_2019,New York Jets_2019,21,22,1
1039,14,1:00PM,San Francisco 49ers_2019,New Orleans Saints_2019,48,46,-2
1040,14,4:05PM,Los Angeles Chargers_2019,Jacksonville Jaguars_2019,45,10,-35
1041,14,4:25PM,Pittsburgh Steelers_2019,Arizona Cardinals_2019,23,17,-6
1042,14,4:25PM,Kansas City Chiefs_2019,New England Patriots_2019,23,16,-7
1043,14,4:25PM,Tennessee Titans_2019,Oakland Raiders_2019,42,21,-21
1044,14,8:20PM,Seattle Seahawks_2019,Los Angeles Rams_2019,12,28,16
1045,14,8:15PM,New York Giants_2019,Philadelphia Eagles_2019,17,23,6
1046,15,8:20PM,New York Jets_2019,Baltimore Ravens_2019,21,42,21
1047,15,1:00PM,Seattle Seahawks_2019,Carolina Panthers_2019,30,24,-6
1048,15,1:00PM,Chicago Bears_2019,Green Bay Packers_2019,13,21,8
1049,15,1:00PM,New England Patriots_2019,Cincinnati Bengals_2019,34,13,-21
1050,15,1:00PM,Denver Broncos_2019,Kansas City Chiefs_2019,3,23,20
1051,15,1:00PM,Tampa Bay Buccaneers_2019,Detroit Lions_2019,38,17,-21
1052,15,1:00PM,Houston Texans_2019,Tennessee Titans_2019,24,21,-3
1053,15,1:00PM,Miami Dolphins_2019,New York Giants_2019,20,36,16
1054,15,1:00PM,Philadelphia Eagles_2019,Washington Redskins_2019,37,27,-10
1055,15,4:05PM,Cleveland Browns_2019,Arizona Cardinals_2019,24,38,14
1056,15,4:05PM,Jacksonville Jaguars_2019,Oakland Raiders_2019,20,16,-4
1057,15,4:05PM,Minnesota Vikings_2019,Los Angeles Chargers_2019,39,10,-29
1058,15,4:25PM,Atlanta Falcons_2019,San Francisco 49ers_2019,29,22,-7
1059,15,4:25PM,Los Angeles Rams_2019,Dallas Cowboys_2019,21,44,23
1060,15,8:20PM,Buffalo Bills_2019,Pittsburgh Steelers_2019,17,10,-7
1061,15,8:15PM,Indianapolis Colts_2019,New Orleans Saints_2019,7,34,27
1062,16,1:00PM,Houston Texans_2019,Tampa Bay Buccaneers_2019,23,20,-3
1063,16,4:30PM,Buffalo Bills_2019,New England Patriots_2019,17,24,7
1064,16,8:15PM,Los Angeles Rams_2019,San Francisco 49ers_2019,31,34,3
1065,16,1:00PM,Jacksonville Jaguars_2019,Atlanta Falcons_2019,12,24,12
1066,16,1:00PM,Carolina Panthers_2019,Indianapolis Colts_2019,6,38,32
1067,16,1:00PM,Cincinnati Bengals_2019,Miami Dolphins_2019,35,38,3
1068,16,1:00PM,Baltimore Ravens_2019,Cleveland Browns_2019,31,15,-16
1069,16,1:00PM,New Orleans Saints_2019,Tennessee Titans_2019,38,28,-10
1070,16,1:00PM,New York Giants_2019,Washington Redskins_2019,41,35,-6
1071,16,1:00PM,Pittsburgh Steelers_2019,New York Jets_2019,10,16,6
1072,16,4:05PM,Detroit Lions_2019,Denver Broncos_2019,17,27,10
1073,16,4:05PM,Oakland Raiders_2019,Los Angeles Chargers_2019,24,17,-7
1074,16,4:25PM,Arizona Cardinals_2019,Seattle Seahawks_2019,27,13,-14
1075,16,4:25PM,Dallas Cowboys_2019,Philadelphia Eagles_2019,9,17,8
1076,16,8:20PM,Kansas City Chiefs_2019,Chicago Bears_2019,26,3,-23
1077,16,8:15PM,Green Bay Packers_2019,Minnesota Vikings_2019,23,10,-13
1078,17,1:00PM,Atlanta Falcons_2019,Tampa Bay Buccaneers_2019,28,22,-6
1079,17,1:00PM,New York Jets_2019,Buffalo Bills_2019,13,6,-7
1080,17,1:00PM,New Orleans Saints_2019,Carolina Panthers_2019,42,10,-32
1081,17,1:00PM,Chicago Bears_2019,Minnesota Vikings_2019,21,19,-2
1082,17,1:00PM,Cleveland Browns_2019,Cincinnati Bengals_2019,23,33,10
1083,17,1:00PM,Green Bay Packers_2019,Detroit Lions_2019,23,20,-3
1084,17,1:00PM,Los Angeles Chargers_2019,Kansas City Chiefs_2019,21,31,10
1085,17,1:00PM,Miami Dolphins_2019,New England Patriots_2019,27,24,-3
1086,17,4:25PM,Indianapolis Colts_2019,Jacksonville Jaguars_2019,20,38,18
1087,17,4:25PM,Arizona Cardinals_2019,Los Angeles Rams_2019,24,31,7
1088,17,4:25PM,Washington Redskins_2019,Dallas Cowboys_2019,16,47,31
1089,17,4:25PM,Oakland Raiders_2019,Denver Broncos_2019,15,16,1
1090,17,4:25PM,Tennessee Titans_2019,Houston Texans_2019,35,14,-21
1091,17,4:25PM,Philadelphia Eagles_2019,New York Giants_2019,34,17,-17
1092,17,4:25PM,Pittsburgh Steelers_2019,Baltimore Ravens_2019,10,28,18
1093,17,8:20PM,San Francisco 49ers_2019,Seattle Seahawks_2019,26,21,-5
1094,WildCard,4:35PM,Buffalo Bills_2019,Houston Texans_2019,19,22,3
1095,WildCard,8:15PM,Tennessee Titans_2019,New England Patriots_2019,20,13,-7
1096,WildCard,1:05PM,Minnesota Vikings_2019,New Orleans Saints_2019,26,20,-6
1097,WildCard,4:40PM,Seattle Seahawks_2019,Philadelphia Eagles_2019,17,9,-8
1098,Division,4:35PM,Minnesota Vikings_2019,San Francisco 49ers_2019,10,27,17
1099,Division,8:15PM,Tennessee Titans_2019,Baltimore Ravens_2019,28,12,-16
1100,Division,3:05PM,Houston Texans_2019,Kansas City Chiefs_2019,31,51,20
1101,Division,6:40PM,Seattle Seahawks_2019,Green Bay Packers_2019,23,28,5
1102,ConfChamp,3:05PM,Tennessee Titans_2019,Kansas City Chiefs_2019,24,35,11
1103,ConfChamp,6:40PM,Green Bay Packers_2019,San Francisco 49ers_2019,20,37,17
1104,SuperBowl,6:30PM,San Francisco 49ers_2019,Kansas City Chiefs_2019,20,31,11
1105,1,8:20PM,Atlanta Falcons_2018,Philadelphia Eagles_2018,12,18,6
1106,1,1:00PM,Buffalo Bills_2018,Baltimore Ravens_2018,3,47,44
1107,1,1:00PM,Cincinnati Bengals_2018,Indianapolis Colts_2018,34,23,-11
1108,1,1:00PM,Pittsburgh Steelers_2018,Cleveland Browns_2018,21,21,0
1109,1,1:00PM,Houston Texans_2018,New England Patriots_2018,20,27,7
1110,1,1:00PM,Jacksonville Jaguars_2018,New York Giants_2018,20,15,-5
1111,1,1:00PM,Tennessee Titans_2018,Miami Dolphins_2018,20,27,7
1112,1,1:00PM,San Francisco 49ers_2018,Minnesota Vikings_2018,16,24,8
1113,1,1:00PM,Tampa Bay Buccaneers_2018,New Orleans Saints_2018,48,40,-8
1114,1,4:05PM,Kansas City Chiefs_2018,Los Angeles Chargers_2018,38,28,-10
1115,1,4:25PM,Dallas Cowboys_2018,Carolina Panthers_2018,8,16,8
1116,1,4:25PM,Washington Redskins_2018,Arizona Cardinals_2018,24,6,-18
1117,1,4:25PM,Seattle Seahawks_2018,Denver Broncos_2018,24,27,3
1118,1,8:20PM,Chicago Bears_2018,Green Bay Packers_2018,23,24,1
1119,1,7:10PM,New York Jets_2018,Detroit Lions_2018,48,17,-31
1120,1,10:20PM,Los Angeles Rams_2018,Oakland Raiders_2018,33,13,-20
1121,2,8:20PM,Baltimore Ravens_2018,Cincinnati Bengals_2018,23,34,11
1122,2,1:00PM,Carolina Panthers_2018,Atlanta Falcons_2018,24,31,7
1123,2,1:00PM,Los Angeles Chargers_2018,Buffalo Bills_2018,31,20,-11
1124,2,1:00PM,Cleveland Browns_2018,New Orleans Saints_2018,18,21,3
1125,2,1:00PM,Indianapolis Colts_2018,Washington Redskins_2018,21,9,-12
1126,2,1:00PM,Minnesota Vikings_2018,Green Bay Packers_2018,29,29,0
1127,2,1:00PM,Houston Texans_2018,Tennessee Titans_2018,17,20,3
1128,2,1:00PM,Kansas City Chiefs_2018,Pittsburgh Steelers_2018,42,37,-5
1129,2,1:00PM,Miami Dolphins_2018,New York Jets_2018,20,12,-8
1130,2,1:00PM,Philadelphia Eagles_2018,Tampa Bay Buccaneers_2018,21,27,6
1131,2,4:05PM,Arizona Cardinals_2018,Los Angeles Rams_2018,0,34,34
1132,2,4:05PM,Detroit Lions_2018,San Francisco 49ers_2018,27,30,3
1133,2,4:25PM,Oakland Raiders_2018,Denver Broncos_2018,19,20,1
1134,2,4:25PM,New England Patriots_2018,Jacksonville Jaguars_2018,20,31,11
1135,2,8:20PM,New York Giants_2018,Dallas Cowboys_2018,13,20,7
1136,2,8:15PM,Seattle Seahawks_2018,Chicago Bears_2018,17,24,7
1137,3,8:20PM,New York Jets_2018,Cleveland Browns_2018,17,21,4
1138,3,1:00PM,New Orleans Saints_2018,Atlanta Falcons_2018,43,37,-6
1139,3,1:00PM,Buffalo Bills_2018,Minnesota Vikings_2018,27,6,-21
1140,3,1:00PM,Cincinnati Bengals_2018,Carolina Panthers_2018,21,31,10
1141,3,1:00PM,Indianapolis Colts_2018,Philadelphia Eagles_2018,16,20,4
1142,3,1:00PM,Denver Broncos_2018,Baltimore Ravens_2018,14,27,13
1143,3,1:00PM,Green Bay Packers_2018,Washington Redskins_2018,17,31,14
1144,3,1:00PM,New York Giants_2018,Houston Texans_2018,27,22,-5
1145,3,1:00PM,Tennessee Titans_2018,Jacksonville Jaguars_2018,9,6,-3
1146,3,1:00PM,San Francisco 49ers_2018,Kansas City Chiefs_2018,27,38,11
1147,3,1:00PM,Oakland Raiders_2018,Miami Dolphins_2018,20,28,8
1148,3,4:05PM,Los Angeles Chargers_2018,Los Angeles Rams_2018,23,35,12
1149,3,4:25PM,Chicago Bears_2018,Arizona Cardinals_2018,16,14,-2
1150,3,4:25PM,Dallas Cowboys_2018,Seattle Seahawks_2018,13,24,11
1151,3,8:20PM,New England Patriots_2018,Detroit Lions_2018,10,26,16
1152,3,8:15PM,Pittsburgh Steelers_2018,Tampa Bay Buccaneers_2018,30,27,-3
1153,4,8:20PM,Minnesota Vikings_2018,Los Angeles Rams_2018,31,38,7
1154,4,1:00PM,Cincinnati Bengals_2018,Atlanta Falcons_2018,37,36,-1
1155,4,1:00PM,Buffalo Bills_2018,Green Bay Packers_2018,0,22,22
1156,4,1:00PM,Tampa Bay Buccaneers_2018,Chicago Bears_2018,10,48,38
1157,4,1:00PM,Houston Texans_2018,Indianapolis Colts_2018,37,34,-3
1158,4,1:00PM,Detroit Lions_2018,Dallas Cowboys_2018,24,26,2
1159,4,1:00PM,New York Jets_2018,Jacksonville Jaguars_2018,12,31,19
1160,4,1:00PM,Miami Dolphins_2018,New England Patriots_2018,7,38,31
1161,4,1:00PM,Philadelphia Eagles_2018,Tennessee Titans_2018,23,26,3
1162,4,4:05PM,Cleveland Browns_2018,Oakland Raiders_2018,42,45,3
1163,4,4:05PM,Seattle Seahawks_2018,Arizona Cardinals_2018,20,17,-3
1164,4,4:25PM,New Orleans Saints_2018,New York Giants_2018,33,18,-15
1165,4,4:25PM,San Francisco 49ers_2018,Los Angeles Chargers_2018,27,29,2
1166,4,8:20PM,Baltimore Ravens_2018,Pittsburgh Steelers_2018,26,14,-12
1167,4,8:15PM,Kansas City Chiefs_2018,Denver Broncos_2018,27,23,-4
1168,5,8:20PM,Indianapolis Colts_2018,New England Patriots_2018,24,38,14
1169,5,1:00PM,New York Giants_2018,Carolina Panthers_2018,31,33,2
1170,5,1:00PM,Atlanta Falcons_2018,Pittsburgh Steelers_2018,17,41,24
1171,5,1:00PM,Tennessee Titans_2018,Buffalo Bills_2018,12,13,1
1172,5,1:00PM,Miami Dolphins_2018,Cincinnati Bengals_2018,17,27,10
1173,5,1:00PM,Baltimore Ravens_2018,Cleveland Browns_2018,9,12,3
1174,5,1:00PM,Denver Broncos_2018,New York Jets_2018,16,34,18
1175,5,1:00PM,Green Bay Packers_2018,Detroit Lions_2018,23,31,8
1176,5,1:00PM,Jacksonville Jaguars_2018,Kansas City Chiefs_2018,14,30,16
1177,5,4:05PM,Oakland Raiders_2018,Los Angeles Chargers_2018,10,26,16
1178,5,4:25PM,Arizona Cardinals_2018,San Francisco 49ers_2018,28,18,-10
1179,5,4:25PM,Minnesota Vikings_2018,Philadelphia Eagles_2018,23,21,-2
1180,5,4:25PM,Los Angeles Rams_2018,Seattle Seahawks_2018,33,31,-2
1181,5,8:20PM,Dallas Cowboys_2018,Houston Texans_2018,16,19,3
1182,5,8:15PM,Washington Redskins_2018,New Orleans Saints_2018,19,43,24
1183,6,8:20PM,Philadelphia Eagles_2018,New York Giants_2018,34,13,-21
1184,6,1:00PM,Carolina Panthers_2018,Washington Redskins_2018,17,23,6
1185,6,1:00PM,Chicago Bears_2018,Miami Dolphins_2018,28,31,3
1186,6,1:00PM,Tampa Bay Buccaneers_2018,Atlanta Falcons_2018,29,34,5
1187,6,1:00PM,Buffalo Bills_2018,Houston Texans_2018,13,20,7
1188,6,1:00PM,Pittsburgh Steelers_2018,Cincinnati Bengals_2018,28,21,-7
1189,6,1:00PM,Los Angeles Chargers_2018,Cleveland Browns_2018,38,14,-24
1190,6,1:00PM,Indianapolis Colts_2018,New York Jets_2018,34,42,8
1191,6,1:00PM,Arizona Cardinals_2018,Minnesota Vikings_2018,17,27,10
1192,6,1:00PM,Seattle Seahawks_2018,Oakland Raiders_2018,27,3,-24
1193,6,4:05PM,Los Angeles Rams_2018,Denver Broncos_2018,23,20,-3
1194,6,4:25PM,Jacksonville Jaguars_2018,Dallas Cowboys_2018,7,40,33
1195,6,4:25PM,Baltimore Ravens_2018,Tennessee Titans_2018,21,0,-21
1196,6,8:20PM,Kansas City Chiefs_2018,New England Patriots_2018,40,43,3
1197,6,8:15PM,San Francisco 49ers_2018,Green Bay Packers_2018,30,33,3
1198,7,8:20PM,Denver Broncos_2018,Arizona Cardinals_2018,45,10,-35
1199,7,9:30AM,Tennessee Titans_2018,Los Angeles Chargers_2018,19,20,1
1200,7,1:00PM,Carolina Panthers_2018,Philadelphia Eagles_2018,21,17,-4
1201,7,1:00PM,New England Patriots_2018,Chicago Bears_2018,38,31,-7
1202,7,1:00PM,Detroit Lions_2018,Miami Dolphins_2018,32,21,-11
1203,7,1:00PM,Buffalo Bills_2018,Indianapolis Colts_2018,5,37,32
1204,7,1:00PM,Cleveland Browns_2018,Tampa Bay Buccaneers_2018,23,26,3
1205,7,1:00PM,Houston Texans_2018,Jacksonville Jaguars_2018,20,7,-13
1206,7,1:00PM,Minnesota Vikings_2018,New York Jets_2018,37,17,-20
1207,7,4:05PM,New Orleans Saints_2018,Baltimore Ravens_2018,24,23,-1
1208,7,4:25PM,Dallas Cowboys_2018,Washington Redskins_2018,17,20,3
1209,7,4:25PM,Los Angeles Rams_2018,San Francisco 49ers_2018,39,10,-29
1210,7,8:20PM,Cincinnati Bengals_2018,Kansas City Chiefs_2018,10,45,35
1211,7,8:15PM,New York Giants_2018,Atlanta Falcons_2018,20,23,3
1212,8,8:20PM,Miami Dolphins_2018,Houston Texans_2018,23,42,19
1213,8,9:30AM,Philadelphia Eagles_2018,Jacksonville Jaguars_2018,24,18,-6
1214,8,1:00PM,Baltimore Ravens_2018,Carolina Panthers_2018,21,36,15
1215,8,1:00PM,New York Jets_2018,Chicago Bears_2018,10,24,14
1216,8,1:00PM,Seattle Seahawks_2018,Detroit Lions_2018,28,14,-14
1217,8,1:00PM,Tampa Bay Buccaneers_2018,Cincinnati Bengals_2018,34,37,3
1218,8,1:00PM,Cleveland Browns_2018,Pittsburgh Steelers_2018,18,33,15
1219,8,1:00PM,Denver Broncos_2018,Kansas City Chiefs_2018,23,30,7
1220,8,1:00PM,Washington Redskins_2018,New York Giants_2018,20,13,-7
1221,8,4:05PM,Indianapolis Colts_2018,Oakland Raiders_2018,42,28,-14
1222,8,4:25PM,Green Bay Packers_2018,Los Angeles Rams_2018,27,29,2
1223,8,4:25PM,San Francisco 49ers_2018,Arizona Cardinals_2018,15,18,3
1224,8,8:20PM,New Orleans Saints_2018,Minnesota Vikings_2018,30,20,-10
1225,8,8:15PM,New England Patriots_2018,Buffalo Bills_2018,25,6,-19
1226,9,8:20PM,Oakland Raiders_2018,San Francisco 49ers_2018,3,34,31
1227,9,1:00PM,Atlanta Falcons_2018,Washington Redskins_2018,38,14,-24
1228,9,1:00PM,Tampa Bay Buccaneers_2018,Carolina Panthers_2018,28,42,14
1229,9,1:00PM,Detroit Lions_2018,Minnesota Vikings_2018,9,24,15
1230,9,1:00PM,Pittsburgh Steelers_2018,Baltimore Ravens_2018,23,16,-7
1231,9,1:00PM,Chicago Bears_2018,Buffalo Bills_2018,41,9,-32
1232,9,1:00PM,Kansas City Chiefs_2018,Cleveland Browns_2018,37,21,-16
1233,9,1:00PM,New York Jets_2018,Miami Dolphins_2018,6,13,7
1234,9,4:05PM,Los Angeles Chargers_2018,Seattle Seahawks_2018,25,17,-8
1235,9,4:05PM,Houston Texans_2018,Denver Broncos_2018,19,17,-2
1236,9,4:25PM,Los Angeles Rams_2018,New Orleans Saints_2018,35,45,10
1237,9,8:20PM,Green Bay Packers_2018,New England Patriots_2018,17,31,14
1238,9,8:15PM,Tennessee Titans_2018,Dallas Cowboys_2018,28,14,-14
1239,10,8:20PM,Carolina Panthers_2018,Pittsburgh Steelers_2018,21,52,31
1240,10,1:00PM,Atlanta Falcons_2018,Cleveland Browns_2018,16,28,12
1241,10,1:00PM,Detroit Lions_2018,Chicago Bears_2018,22,34,12
1242,10,1:00PM,New Orleans Saints_2018,Cincinnati Bengals_2018,51,14,-37
1243,10,1:00PM,Jacksonville Jaguars_2018,Indianapolis Colts_2018,26,29,3
1244,10,1:00PM,Arizona Cardinals_2018,Kansas City Chiefs_2018,14,26,12
1245,10,1:00PM,Washington Redskins_2018,Tampa Bay Buccaneers_2018,16,3,-13
1246,10,1:00PM,Buffalo Bills_2018,New York Jets_2018,41,10,-31
1247,10,1:00PM,New England Patriots_2018,Tennessee Titans_2018,10,34,24
1248,10,4:05PM,Los Angeles Chargers_2018,Oakland Raiders_2018,20,6,-14
1249,10,4:25PM,Miami Dolphins_2018,Green Bay Packers_2018,12,31,19
1250,10,4:25PM,Seattle Seahawks_2018,Los Angeles Rams_2018,31,36,5
1251,10,8:20PM,Dallas Cowboys_2018,Philadelphia Eagles_2018,27,20,-7
1252,10,8:15PM,New York Giants_2018,San Francisco 49ers_2018,27,23,-4
1253,11,8:20PM,Green Bay Packers_2018,Seattle Seahawks_2018,24,27,3
1254,11,1:00PM,Dallas Cowboys_2018,Atlanta Falcons_2018,22,19,-3
1255,11,1:00PM,Carolina Panthers_2018,Detroit Lions_2018,19,20,1
1256,11,1:00PM,Cincinnati Bengals_2018,Baltimore Ravens_2018,21,24,3
1257,11,1:00PM,Tennessee Titans_2018,Indianapolis Colts_2018,10,38,28
1258,11,1:00PM,Houston Texans_2018,Washington Redskins_2018,23,21,-2
1259,11,1:00PM,Pittsburgh Steelers_2018,Jacksonville Jaguars_2018,20,16,-4
1260,11,1:00PM,Tampa Bay Buccaneers_2018,New York Giants_2018,35,38,3
1261,11,4:05PM,Oakland Raiders_2018,Arizona Cardinals_2018,23,21,-2
1262,11,4:05PM,Denver Broncos_2018,Los Angeles Chargers_2018,23,22,-1
1263,11,4:25PM,Philadelphia Eagles_2018,New Orleans Saints_2018,7,48,41
1264,11,8:20PM,Minnesota Vikings_2018,Chicago Bears_2018,20,25,5
1265,11,8:15PM,Kansas City Chiefs_2018,Los Angeles Rams_2018,51,54,3
1266,12,12:30PM,Chicago Bears_2018,Detroit Lions_2018,23,16,-7
1267,12,4:30PM,Washington Redskins_2018,Dallas Cowboys_2018,23,31,8
1268,12,8:20PM,Atlanta Falcons_2018,New Orleans Saints_2018,17,31,14
1269,12,1:00PM,Jacksonville Jaguars_2018,Buffalo Bills_2018,21,24,3
1270,12,1:00PM,Seattle Seahawks_2018,Carolina Panthers_2018,30,27,-3
1271,12,1:00PM,Cleveland Browns_2018,Cincinnati Bengals_2018,35,20,-15
1272,12,1:00PM,New England Patriots_2018,New York Jets_2018,27,13,-14
1273,12,1:00PM,New York Giants_2018,Philadelphia Eagles_2018,22,25,3
1274,12,1:00PM,Oakland Raiders_2018,Baltimore Ravens_2018,17,34,17
1275,12,1:00PM,San Francisco 49ers_2018,Tampa Bay Buccaneers_2018,9,27,18
1276,12,4:05PM,Arizona Cardinals_2018,Los Angeles Chargers_2018,10,45,35
1277,12,4:25PM,Miami Dolphins_2018,Indianapolis Colts_2018,24,27,3
1278,12,4:25PM,Pittsburgh Steelers_2018,Denver Broncos_2018,17,24,7
1279,12,8:20PM,Green Bay Packers_2018,Minnesota Vikings_2018,17,24,7
1280,12,8:15PM,Tennessee Titans_2018,Houston Texans_2018,17,34,17
1281,13,8:20PM,New Orleans Saints_2018,Dallas Cowboys_2018,10,13,3
1282,13,1:00PM,Baltimore Ravens_2018,Atlanta Falcons_2018,26,16,-10
1283,13,1:00PM,Buffalo Bills_2018,Miami Dolphins_2018,17,21,4
1284,13,1:00PM,Carolina Panthers_2018,Tampa Bay Buccaneers_2018,17,24,7
1285,13,1:00PM,Chicago Bears_2018,New York Giants_2018,27,30,3
1286,13,1:00PM,Denver Broncos_2018,Cincinnati Bengals_2018,24,10,-14
1287,13,1:00PM,Cleveland Browns_2018,Houston Texans_2018,13,29,16
1288,13,1:00PM,Indianapolis Colts_2018,Jacksonville Jaguars_2018,0,6,6
1289,13,1:00PM,Arizona Cardinals_2018,Green Bay Packers_2018,20,17,-3
1290,13,1:00PM,Los Angeles Rams_2018,Detroit Lions_2018,30,16,-14
1291,13,4:05PM,Kansas City Chiefs_2018,Oakland Raiders_2018,40,33,-7
1292,13,4:05PM,New York Jets_2018,Tennessee Titans_2018,22,26,4
1293,13,4:25PM,Minnesota Vikings_2018,New England Patriots_2018,10,24,14
1294,13,4:25PM,San Francisco 49ers_2018,Seattle Seahawks_2018,16,43,27
1295,13,8:20PM,Los Angeles Chargers_2018,Pittsburgh Steelers_2018,33,30,-3
1296,13,8:15PM,Washington Redskins_2018,Philadelphia Eagles_2018,13,28,15
1297,14,8:20PM,Jacksonville Jaguars_2018,Tennessee Titans_2018,9,30,21
1298,14,1:00PM,Atlanta Falcons_2018,Green Bay Packers_2018,20,34,14
1299,14,1:00PM,New York Jets_2018,Buffalo Bills_2018,27,23,-4
1300,14,1:00PM,Carolina Panthers_2018,Cleveland Browns_2018,20,26,6
1301,14,1:00PM,Indianapolis Colts_2018,Houston Texans_2018,24,21,-3
1302,14,1:00PM,Baltimore Ravens_2018,Kansas City Chiefs_2018,24,27,3
1303,14,1:00PM,New England Patriots_2018,Miami Dolphins_2018,33,34,1
1304,14,1:00PM,New Orleans Saints_2018,Tampa Bay Buccaneers_2018,28,14,-14
1305,14,1:00PM,New York Giants_2018,Washington Redskins_2018,40,16,-24
1306,14,4:05PM,Cincinnati Bengals_2018,Los Angeles Chargers_2018,21,26,5
1307,14,4:05PM,Denver Broncos_2018,San Francisco 49ers_2018,14,20,6
1308,14,4:25PM,Detroit Lions_2018,Arizona Cardinals_2018,17,3,-14
1309,14,4:25PM,Philadelphia Eagles_2018,Dallas Cowboys_2018,23,29,6
1310,14,4:25PM,Pittsburgh Steelers_2018,Oakland Raiders_2018,21,24,3
1311,14,8:20PM,Los Angeles Rams_2018,Chicago Bears_2018,6,15,9
1312,14,8:15PM,Minnesota Vikings_2018,Seattle Seahawks_2018,7,21,14
1313,15,8:20PM,Los Angeles Chargers_2018,Kansas City Chiefs_2018,29,28,-1
1314,15,4:30PM,Houston Texans_2018,New York Jets_2018,29,22,-7
1315,15,8:20PM,Cleveland Browns_2018,Denver Broncos_2018,17,16,-1
1316,15,1:00PM,Arizona Cardinals_2018,Atlanta Falcons_2018,14,40,26
1317,15,1:00PM,Detroit Lions_2018,Buffalo Bills_2018,13,14,1
1318,15,1:00PM,Green Bay Packers_2018,Chicago Bears_2018,17,24,7
1319,15,1:00PM,Oakland Raiders_2018,Cincinnati Bengals_2018,16,30,14
1320,15,1:00PM,Dallas Cowboys_2018,Indianapolis Colts_2018,0,23,23
1321,15,1:00PM,Washington Redskins_2018,Jacksonville Jaguars_2018,16,13,-3
1322,15,1:00PM,Miami Dolphins_2018,Minnesota Vikings_2018,17,41,24
1323,15,1:00PM,Tennessee Titans_2018,New York Giants_2018,17,0,-17
1324,15,1:00PM,Tampa Bay Buccaneers_2018,Baltimore Ravens_2018,12,20,8
1325,15,4:05PM,Seattle Seahawks_2018,San Francisco 49ers_2018,23,26,3
1326,15,4:25PM,New England Patriots_2018,Pittsburgh Steelers_2018,10,17,7
1327,15,8:20PM,Philadelphia Eagles_2018,Los Angeles Rams_2018,30,23,-7
1328,15,8:15PM,New Orleans Saints_2018,Carolina Panthers_2018,12,9,-3
1329,16,4:30PM,Washington Redskins_2018,Tennessee Titans_2018,16,25,9
1330,16,8:20PM,Baltimore Ravens_2018,Los Angeles Chargers_2018,22,10,-12
1331,16,1:00PM,Atlanta Falcons_2018,Carolina Panthers_2018,24,10,-14
1332,16,1:00PM,Buffalo Bills_2018,New England Patriots_2018,12,24,12
1333,16,1:00PM,Cincinnati Bengals_2018,Cleveland Browns_2018,18,26,8
1334,16,1:00PM,New York Giants_2018,Indianapolis Colts_2018,27,28,1
1335,16,1:00PM,Tampa Bay Buccaneers_2018,Dallas Cowboys_2018,20,27,7
1336,16,1:00PM,Minnesota Vikings_2018,Detroit Lions_2018,27,9,-18
1337,16,1:00PM,Green Bay Packers_2018,New York Jets_2018,44,38,-6
1338,16,1:00PM,Houston Texans_2018,Philadelphia Eagles_2018,30,32,2
1339,16,1:00PM,Jacksonville Jaguars_2018,Miami Dolphins_2018,17,7,-10
1340,16,4:05PM,Chicago Bears_2018,San Francisco 49ers_2018,14,9,-5
1341,16,4:05PM,Los Angeles Rams_2018,Arizona Cardinals_2018,31,9,-22
1342,16,4:25PM,Pittsburgh Steelers_2018,New Orleans Saints_2018,28,31,3
1343,16,8:20PM,Kansas City Chiefs_2018,Seattle Seahawks_2018,31,38,7
1344,16,8:15PM,Denver Broncos_2018,Oakland Raiders_2018,14,27,13
1345,17,1:00PM,Atlanta Falcons_2018,Tampa Bay Buccaneers_2018,34,32,-2
1346,17,1:00PM,Miami Dolphins_2018,Buffalo Bills_2018,17,42,25
1347,17,1:00PM,Carolina Panthers_2018,New Orleans Saints_2018,33,14,-19
1348,17,1:00PM,Dallas Cowboys_2018,New York Giants_2018,36,35,-1
1349,17,1:00PM,Detroit Lions_2018,Green Bay Packers_2018,31,0,-31
1350,17,1:00PM,Jacksonville Jaguars_2018,Houston Texans_2018,3,20,17
1351,17,1:00PM,New York Jets_2018,New England Patriots_2018,3,38,35
1352,17,4:25PM,Chicago Bears_2018,Minnesota Vikings_2018,24,10,-14
1353,17,4:25PM,Cincinnati Bengals_2018,Pittsburgh Steelers_2018,13,16,3
1354,17,4:25PM,Cleveland Browns_2018,Baltimore Ravens_2018,24,26,2
1355,17,4:25PM,Arizona Cardinals_2018,Seattle Seahawks_2018,24,27,3
1356,17,4:25PM,Los Angeles Chargers_2018,Denver Broncos_2018,23,9,-14
1357,17,4:25PM,Oakland Raiders_2018,Kansas City Chiefs_2018,3,35,32
1358,17,4:25PM,Philadelphia Eagles_2018,Washington Redskins_2018,24,0,-24
1359,17,4:25PM,San Francisco 49ers_2018,Los Angeles Rams_2018,32,48,16
1360,17,8:20PM,Indianapolis Colts_2018,Tennessee Titans_2018,33,17,-16
1361,WildCard,4:35PM,Indianapolis Colts_2018,Houston Texans_2018,21,7,-14
1362,WildCard,8:15PM,Seattle Seahawks_2018,Dallas Cowboys_2018,22,24,2
1363,WildCard,1:05PM,Los Angeles Chargers_2018,Baltimore Ravens_2018,23,17,-6
1364,WildCard,4:40PM,Philadelphia Eagles_2018,Chicago Bears_2018,16,15,-1
1365,Division,4:35PM,Indianapolis Colts_2018,Kansas City Chiefs_2018,13,31,18
1366,Division,8:15PM,Dallas Cowboys_2018,Los Angeles Rams_2018,22,30,8
1367,Division,1:05PM,Los Angeles Chargers_2018,New England Patriots_2018,28,41,13
1368,Division,4:40PM,Philadelphia Eagles_2018,New Orleans Saints_2018,14,20,6
1369,ConfChamp,3:05PM,Los Angeles Rams_2018,New Orleans Saints_2018,26,23,-3
1370,ConfChamp,6:40PM,New England Patriots_2018,Kansas City Chiefs_2018,37,31,-6
1371,SuperBowl,6:30PM,Los Angeles Rams_2018,New England Patriots_2018,3,13,10
1372,1,8:30PM,Kansas City Chiefs_2017,New England Patriots_2017,42,27,-15
1373,1,1:00PM,Atlanta Falcons_2017,Chicago Bears_2017,23,17,-6
1374,1,1:00PM,New York Jets_2017,Buffalo Bills_2017,12,21,9
1375,1,1:00PM,Baltimore Ravens_2017,Cincinnati Bengals_2017,20,0,-20
1376,1,1:00PM,Pittsburgh Steelers_2017,Cleveland Browns_2017,21,18,-3
1377,1,1:00PM,Arizona Cardinals_2017,Detroit Lions_2017,23,35,12
1378,1,1:00PM,Jacksonville Jaguars_2017,Houston Texans_2017,29,7,-22
1379,1,1:00PM,Oakland Raiders_2017,Tennessee Titans_2017,26,16,-10
1380,1,1:00PM,Philadelphia Eagles_2017,Washington Redskins_2017,30,17,-13
1381,1,4:05PM,Indianapolis Colts_2017,Los Angeles Rams_2017,9,46,37
1382,1,4:25PM,Carolina Panthers_2017,San Francisco 49ers_2017,23,3,-20
1383,1,4:25PM,Seattle Seahawks_2017,Green Bay Packers_2017,9,17,8
1384,1,8:30PM,New York Giants_2017,Dallas Cowboys_2017,3,19,16
1385,1,7:10PM,New Orleans Saints_2017,Minnesota Vikings_2017,19,29,10
1386,1,10:20PM,Los Angeles Chargers_2017,Denver Broncos_2017,21,24,3
1387,2,8:25PM,Houston Texans_2017,Cincinnati Bengals_2017,13,9,-4
1388,2,1:00PM,Buffalo Bills_2017,Carolina Panthers_2017,3,9,6
1389,2,1:00PM,Chicago Bears_2017,Tampa Bay Buccaneers_2017,7,29,22
1390,2,1:00PM,Cleveland Browns_2017,Baltimore Ravens_2017,10,24,14
1391,2,1:00PM,Arizona Cardinals_2017,Indianapolis Colts_2017,16,13,-3
1392,2,1:00PM,Tennessee Titans_2017,Jacksonville Jaguars_2017,37,16,-21
1393,2,1:00PM,Philadelphia Eagles_2017,Kansas City Chiefs_2017,20,27,7
1394,2,1:00PM,Minnesota Vikings_2017,Pittsburgh Steelers_2017,9,26,17
1395,2,1:00PM,New England Patriots_2017,New Orleans Saints_2017,36,20,-16
1396,2,4:05PM,Miami Dolphins_2017,Los Angeles Chargers_2017,19,17,-2
1397,2,4:05PM,New York Jets_2017,Oakland Raiders_2017,20,45,25
1398,2,4:25PM,Dallas Cowboys_2017,Denver Broncos_2017,17,42,25
1399,2,4:25PM,Washington Redskins_2017,Los Angeles Rams_2017,27,20,-7
1400,2,4:25PM,San Francisco 49ers_2017,Seattle Seahawks_2017,9,12,3
1401,2,8:30PM,Green Bay Packers_2017,Atlanta Falcons_2017,23,34,11
1402,2,8:30PM,Detroit Lions_2017,New York Giants_2017,24,10,-14
1403,3,8:25PM,Los Angeles Rams_2017,San Francisco 49ers_2017,41,39,-2
1404,3,9:30AM,Baltimore Ravens_2017,Jacksonville Jaguars_2017,7,44,37
1405,3,1:00PM,Miami Dolphins_2017,New York Jets_2017,6,20,14
1406,3,1:00PM,Atlanta Falcons_2017,Detroit Lions_2017,30,26,-4
1407,3,1:00PM,Denver Broncos_2017,Buffalo Bills_2017,16,26,10
1408,3,1:00PM,New Orleans Saints_2017,Carolina Panthers_2017,34,13,-21
1409,3,1:00PM,Pittsburgh Steelers_2017,Chicago Bears_2017,17,23,6
1410,3,1:00PM,Cleveland Browns_2017,Indianapolis Colts_2017,28,31,3
1411,3,1:00PM,Houston Texans_2017,New England Patriots_2017,33,36,3
1412,3,1:00PM,Tampa Bay Buccaneers_2017,Minnesota Vikings_2017,17,34,17
1413,3,1:00PM,New York Giants_2017,Philadelphia Eagles_2017,24,27,3
1414,3,4:05PM,Seattle Seahawks_2017,Tennessee Titans_2017,27,33,6
1415,3,4:25PM,Cincinnati Bengals_2017,Green Bay Packers_2017,24,27,3
1416,3,4:25PM,Kansas City Chiefs_2017,Los Angeles Chargers_2017,24,10,-14
1417,3,8:30PM,Oakland Raiders_2017,Washington Redskins_2017,10,27,17
1418,3,8:30PM,Dallas Cowboys_2017,Arizona Cardinals_2017,28,17,-11
1419,4,8:25PM,Chicago Bears_2017,Green Bay Packers_2017,14,35,21
1420,4,9:30AM,New Orleans Saints_2017,Miami Dolphins_2017,20,0,-20
1421,4,1:00PM,Buffalo Bills_2017,Atlanta Falcons_2017,23,17,-6
1422,4,1:00PM,Carolina Panthers_2017,New England Patriots_2017,33,30,-3
1423,4,1:00PM,Cincinnati Bengals_2017,Cleveland Browns_2017,31,7,-24
1424,4,1:00PM,Los Angeles Rams_2017,Dallas Cowboys_2017,35,30,-5
1425,4,1:00PM,Detroit Lions_2017,Minnesota Vikings_2017,14,7,-7
1426,4,1:00PM,Tennessee Titans_2017,Houston Texans_2017,14,57,43
1427,4,1:00PM,Jacksonville Jaguars_2017,New York Jets_2017,20,23,3
1428,4,1:00PM,Pittsburgh Steelers_2017,Baltimore Ravens_2017,26,9,-17
1429,4,4:05PM,San Francisco 49ers_2017,Arizona Cardinals_2017,15,18,3
1430,4,4:05PM,New York Giants_2017,Tampa Bay Buccaneers_2017,23,25,2
1431,4,4:05PM,Philadelphia Eagles_2017,Los Angeles Chargers_2017,26,24,-2
1432,4,4:25PM,Oakland Raiders_2017,Denver Broncos_2017,10,16,6
1433,4,8:30PM,Indianapolis Colts_2017,Seattle Seahawks_2017,18,46,28
1434,4,8:30PM,Washington Redskins_2017,Kansas City Chiefs_2017,20,29,9
1435,5,8:25PM,New England Patriots_2017,Tampa Bay Buccaneers_2017,19,14,-5
1436,5,1:00PM,Tennessee Titans_2017,Miami Dolphins_2017,10,16,6
1437,5,1:00PM,Buffalo Bills_2017,Cincinnati Bengals_2017,16,20,4
1438,5,1:00PM,Carolina Panthers_2017,Detroit Lions_2017,27,24,-3
1439,5,1:00PM,New York Jets_2017,Cleveland Browns_2017,17,14,-3
1440,5,1:00PM,San Francisco 49ers_2017,Indianapolis Colts_2017,23,26,3
1441,5,1:00PM,Arizona Cardinals_2017,Philadelphia Eagles_2017,7,34,27
1442,5,1:00PM,Jacksonville Jaguars_2017,Pittsburgh Steelers_2017,30,9,-21
1443,5,1:00PM,Los Angeles Chargers_2017,New York Giants_2017,27,22,-5
1444,5,4:05PM,Baltimore Ravens_2017,Oakland Raiders_2017,30,17,-13
1445,5,4:05PM,Seattle Seahawks_2017,Los Angeles Rams_2017,16,10,-6
1446,5,4:25PM,Green Bay Packers_2017,Dallas Cowboys_2017,35,31,-4
1447,5,8:30PM,Kansas City Chiefs_2017,Houston Texans_2017,42,34,-8
1448,5,8:30PM,Minnesota Vikings_2017,Chicago Bears_2017,20,17,-3
1449,6,8:25PM,Philadelphia Eagles_2017,Carolina Panthers_2017,28,23,-5
1450,6,1:00PM,Miami Dolphins_2017,Atlanta Falcons_2017,20,17,-3
1451,6,1:00PM,Chicago Bears_2017,Baltimore Ravens_2017,27,24,-3
1452,6,1:00PM,Cleveland Browns_2017,Houston Texans_2017,17,33,16
1453,6,1:00PM,Detroit Lions_2017,New Orleans Saints_2017,38,52,14
1454,6,1:00PM,Green Bay Packers_2017,Minnesota Vikings_2017,10,23,13
1455,6,1:00PM,New England Patriots_2017,New York Jets_2017,24,17,-7
1456,6,1:00PM,San Francisco 49ers_2017,Washington Redskins_2017,24,26,2
1457,6,4:05PM,Tampa Bay Buccaneers_2017,Arizona Cardinals_2017,33,38,5
1458,6,4:05PM,Los Angeles Rams_2017,Jacksonville Jaguars_2017,27,17,-10
1459,6,4:25PM,Pittsburgh Steelers_2017,Kansas City Chiefs_2017,19,13,-6
1460,6,4:25PM,Los Angeles Chargers_2017,Oakland Raiders_2017,17,16,-1
1461,6,8:30PM,New York Giants_2017,Denver Broncos_2017,23,10,-13
1462,6,8:30PM,Indianapolis Colts_2017,Tennessee Titans_2017,22,36,14
1463,7,8:25PM,Kansas City Chiefs_2017,Oakland Raiders_2017,30,31,1
1464,7,1:00PM,Tampa Bay Buccaneers_2017,Buffalo Bills_2017,27,30,3
1465,7,1:00PM,New York Jets_2017,Miami Dolphins_2017,28,31,3
1466,7,1:00PM,Carolina Panthers_2017,Chicago Bears_2017,3,17,14
1467,7,1:00PM,Tennessee Titans_2017,Cleveland Browns_2017,12,9,-3
1468,7,1:00PM,Jacksonville Jaguars_2017,Indianapolis Colts_2017,27,0,-27
1469,7,1:00PM,Arizona Cardinals_2017,Los Angeles Rams_2017,0,33,33
1470,7,1:00PM,New Orleans Saints_2017,Green Bay Packers_2017,26,17,-9
1471,7,1:00PM,Baltimore Ravens_2017,Minnesota Vikings_2017,16,24,8
1472,7,4:05PM,Dallas Cowboys_2017,San Francisco 49ers_2017,40,10,-30
1473,7,4:25PM,Cincinnati Bengals_2017,Pittsburgh Steelers_2017,14,29,15
1474,7,4:25PM,Denver Broncos_2017,Los Angeles Chargers_2017,0,21,21
1475,7,4:25PM,Seattle Seahawks_2017,New York Giants_2017,24,7,-17
1476,7,8:30PM,Atlanta Falcons_2017,New England Patriots_2017,7,23,16
1477,7,8:30PM,Washington Redskins_2017,Philadelphia Eagles_2017,24,34,10
1478,8,8:25PM,Miami Dolphins_2017,Baltimore Ravens_2017,0,40,40
1479,8,9:30AM,Minnesota Vikings_2017,Cleveland Browns_2017,33,16,-17
1480,8,1:00PM,Atlanta Falcons_2017,New York Jets_2017,25,20,-5
1481,8,1:00PM,Oakland Raiders_2017,Buffalo Bills_2017,14,34,20
1482,8,1:00PM,Indianapolis Colts_2017,Cincinnati Bengals_2017,23,24,1
1483,8,1:00PM,Carolina Panthers_2017,Tampa Bay Buccaneers_2017,17,3,-14
1484,8,1:00PM,Chicago Bears_2017,New Orleans Saints_2017,12,20,8
1485,8,1:00PM,Los Angeles Chargers_2017,New England Patriots_2017,13,21,8
1486,8,1:00PM,San Francisco 49ers_2017,Philadelphia Eagles_2017,10,33,23
1487,8,4:05PM,Houston Texans_2017,Seattle Seahawks_2017,38,41,3
1488,8,4:25PM,Dallas Cowboys_2017,Washington Redskins_2017,33,19,-14
1489,8,8:30PM,Pittsburgh Steelers_2017,Detroit Lions_2017,20,15,-5
1490,8,8:30PM,Denver Broncos_2017,Kansas City Chiefs_2017,19,29,10
1491,9,8:25PM,Buffalo Bills_2017,New York Jets_2017,21,34,13
1492,9,1:00PM,Atlanta Falcons_2017,Carolina Panthers_2017,17,20,3
1493,9,1:00PM,Cincinnati Bengals_2017,Jacksonville Jaguars_2017,7,23,16
1494,9,1:00PM,Denver Broncos_2017,Philadelphia Eagles_2017,23,51,28
1495,9,1:00PM,Tampa Bay Buccaneers_2017,New Orleans Saints_2017,10,30,20
1496,9,1:00PM,Los Angeles Rams_2017,New York Giants_2017,51,17,-34
1497,9,1:00PM,Baltimore Ravens_2017,Tennessee Titans_2017,20,23,3
1498,9,1:00PM,Indianapolis Colts_2017,Houston Texans_2017,20,14,-6
1499,9,4:05PM,Arizona Cardinals_2017,San Francisco 49ers_2017,20,10,-10
1500,9,4:05PM,Washington Redskins_2017,Seattle Seahawks_2017,17,14,-3
1501,9,4:25PM,Kansas City Chiefs_2017,Dallas Cowboys_2017,17,28,11
1502,9,8:30PM,Oakland Raiders_2017,Miami Dolphins_2017,27,24,-3
1503,9,8:30PM,Detroit Lions_2017,Green Bay Packers_2017,30,17,-13
1504,10,8:25PM,Seattle Seahawks_2017,Arizona Cardinals_2017,22,16,-6
1505,10,1:00PM,New Orleans Saints_2017,Buffalo Bills_2017,47,10,-37
1506,10,1:00PM,Green Bay Packers_2017,Chicago Bears_2017,23,16,-7
1507,10,1:00PM,Cincinnati Bengals_2017,Tennessee Titans_2017,20,24,4
1508,10,1:00PM,Cleveland Browns_2017,Detroit Lions_2017,24,38,14
1509,10,1:00PM,Los Angeles Chargers_2017,Jacksonville Jaguars_2017,17,20,3
1510,10,1:00PM,Minnesota Vikings_2017,Washington Redskins_2017,38,30,-8
1511,10,1:00PM,Pittsburgh Steelers_2017,Indianapolis Colts_2017,20,17,-3
1512,10,1:00PM,New York Jets_2017,Tampa Bay Buccaneers_2017,10,15,5
1513,10,4:05PM,Houston Texans_2017,Los Angeles Rams_2017,7,33,26
1514,10,4:25PM,Dallas Cowboys_2017,Atlanta Falcons_2017,7,27,20
1515,10,4:25PM,New York Giants_2017,San Francisco 49ers_2017,21,31,10
1516,10,8:30PM,New England Patriots_2017,Denver Broncos_2017,41,16,-25
1517,10,8:30PM,Miami Dolphins_2017,Carolina Panthers_2017,21,45,24
1518,11,8:25PM,Tennessee Titans_2017,Pittsburgh Steelers_2017,17,40,23
1519,11,1:00PM,Detroit Lions_2017,Chicago Bears_2017,27,24,-3
1520,11,1:00PM,Jacksonville Jaguars_2017,Cleveland Browns_2017,19,7,-12
1521,11,1:00PM,Arizona Cardinals_2017,Houston Texans_2017,21,31,10
1522,11,1:00PM,Baltimore Ravens_2017,Green Bay Packers_2017,23,0,-23
1523,11,1:00PM,Kansas City Chiefs_2017,New York Giants_2017,9,12,3
1524,11,1:00PM,Tampa Bay Buccaneers_2017,Miami Dolphins_2017,30,20,-10
1525,11,1:00PM,Los Angeles Rams_2017,Minnesota Vikings_2017,7,24,17
1526,11,1:00PM,Washington Redskins_2017,New Orleans Saints_2017,31,34,3
1527,11,4:05PM,Buffalo Bills_2017,Los Angeles Chargers_2017,24,54,30
1528,11,4:25PM,Cincinnati Bengals_2017,Denver Broncos_2017,20,17,-3
1529,11,4:25PM,New England Patriots_2017,Oakland Raiders_2017,33,8,-25
1530,11,8:30PM,Philadelphia Eagles_2017,Dallas Cowboys_2017,37,9,-28
1531,11,8:30PM,Atlanta Falcons_2017,Seattle Seahawks_2017,34,31,-3
1532,12,12:30PM,Minnesota Vikings_2017,Detroit Lions_2017,30,23,-7
1533,12,4:30PM,Los Angeles Chargers_2017,Dallas Cowboys_2017,28,6,-22
1534,12,8:30PM,New York Giants_2017,Washington Redskins_2017,10,20,10
1535,12,1:00PM,Tampa Bay Buccaneers_2017,Atlanta Falcons_2017,20,34,14
1536,12,1:00PM,Buffalo Bills_2017,Kansas City Chiefs_2017,16,10,-6
1537,12,1:00PM,Carolina Panthers_2017,New York Jets_2017,35,27,-8
1538,12,1:00PM,Chicago Bears_2017,Philadelphia Eagles_2017,3,31,28
1539,12,1:00PM,Cleveland Browns_2017,Cincinnati Bengals_2017,16,30,14
1540,12,1:00PM,Tennessee Titans_2017,Indianapolis Colts_2017,20,16,-4
1541,12,1:00PM,Miami Dolphins_2017,New England Patriots_2017,17,35,18
1542,12,4:05PM,Seattle Seahawks_2017,San Francisco 49ers_2017,24,13,-11
1543,12,4:25PM,Jacksonville Jaguars_2017,Arizona Cardinals_2017,24,27,3
1544,12,4:25PM,Denver Broncos_2017,Oakland Raiders_2017,14,21,7
1545,12,4:25PM,New Orleans Saints_2017,Los Angeles Rams_2017,20,26,6
1546,12,8:30PM,Green Bay Packers_2017,Pittsburgh Steelers_2017,28,31,3
1547,12,8:30PM,Houston Texans_2017,Baltimore Ravens_2017,16,23,7
1548,13,8:25PM,Washington Redskins_2017,Dallas Cowboys_2017,14,38,24
1549,13,1:00PM,Minnesota Vikings_2017,Atlanta Falcons_2017,14,9,-5
1550,13,1:00PM,New England Patriots_2017,Buffalo Bills_2017,23,3,-20
1551,13,1:00PM,San Francisco 49ers_2017,Chicago Bears_2017,15,14,-1
1552,13,1:00PM,Indianapolis Colts_2017,Jacksonville Jaguars_2017,10,30,20
1553,13,1:00PM,Denver Broncos_2017,Miami Dolphins_2017,9,35,26
1554,13,1:00PM,Detroit Lions_2017,Baltimore Ravens_2017,20,44,24
1555,13,1:00PM,Tampa Bay Buccaneers_2017,Green Bay Packers_2017,20,26,6
1556,13,1:00PM,Houston Texans_2017,Tennessee Titans_2017,13,24,11
1557,13,1:00PM,Kansas City Chiefs_2017,New York Jets_2017,31,38,7
1558,13,4:05PM,Cleveland Browns_2017,Los Angeles Chargers_2017,10,19,9
1559,13,4:25PM,Carolina Panthers_2017,New Orleans Saints_2017,21,31,10
1560,13,4:25PM,Los Angeles Rams_2017,Arizona Cardinals_2017,32,16,-16
1561,13,4:25PM,New York Giants_2017,Oakland Raiders_2017,17,24,7
1562,13,8:30PM,Philadelphia Eagles_2017,Seattle Seahawks_2017,10,24,14
1563,13,8:30PM,Pittsburgh Steelers_2017,Cincinnati Bengals_2017,23,20,-3
1564,14,8:25PM,New Orleans Saints_2017,Atlanta Falcons_2017,17,20,3
1565,14,1:00PM,Indianapolis Colts_2017,Buffalo Bills_2017,7,13,6
1566,14,1:00PM,Minnesota Vikings_2017,Carolina Panthers_2017,24,31,7
1567,14,1:00PM,Chicago Bears_2017,Cincinnati Bengals_2017,33,7,-26
1568,14,1:00PM,Green Bay Packers_2017,Cleveland Browns_2017,27,21,-6
1569,14,1:00PM,Dallas Cowboys_2017,New York Giants_2017,30,10,-20
1570,14,1:00PM,Detroit Lions_2017,Tampa Bay Buccaneers_2017,24,21,-3
1571,14,1:00PM,San Francisco 49ers_2017,Houston Texans_2017,26,16,-10
1572,14,1:00PM,Oakland Raiders_2017,Kansas City Chiefs_2017,15,26,11
1573,14,4:05PM,Tennessee Titans_2017,Arizona Cardinals_2017,7,12,5
1574,14,4:05PM,New York Jets_2017,Denver Broncos_2017,0,23,23
1575,14,4:05PM,Washington Redskins_2017,Los Angeles Chargers_2017,13,30,17
1576,14,4:25PM,Seattle Seahawks_2017,Jacksonville Jaguars_2017,24,30,6
1577,14,4:25PM,Philadelphia Eagles_2017,Los Angeles Rams_2017,43,35,-8
1578,14,8:30PM,Baltimore Ravens_2017,Pittsburgh Steelers_2017,38,39,1
1579,14,8:30PM,New England Patriots_2017,Miami Dolphins_2017,20,27,7
1580,15,8:25PM,Denver Broncos_2017,Indianapolis Colts_2017,25,13,-12
1581,15,4:30PM,Chicago Bears_2017,Detroit Lions_2017,10,20,10
1582,15,8:25PM,Los Angeles Chargers_2017,Kansas City Chiefs_2017,13,30,17
1583,15,1:00PM,Miami Dolphins_2017,Buffalo Bills_2017,16,24,8
1584,15,1:00PM,Green Bay Packers_2017,Carolina Panthers_2017,24,31,7
1585,15,1:00PM,Cincinnati Bengals_2017,Minnesota Vikings_2017,7,34,27
1586,15,1:00PM,Baltimore Ravens_2017,Cleveland Browns_2017,27,10,-17
1587,15,1:00PM,Arizona Cardinals_2017,Washington Redskins_2017,15,20,5
1588,15,1:00PM,Houston Texans_2017,Jacksonville Jaguars_2017,7,45,38
1589,15,1:00PM,New York Jets_2017,New Orleans Saints_2017,19,31,12
1590,15,1:00PM,Philadelphia Eagles_2017,New York Giants_2017,34,29,-5
1591,15,4:05PM,Los Angeles Rams_2017,Seattle Seahawks_2017,42,7,-35
1592,15,4:25PM,New England Patriots_2017,Pittsburgh Steelers_2017,27,24,-3
1593,15,4:25PM,Tennessee Titans_2017,San Francisco 49ers_2017,23,25,2
1594,15,8:30PM,Dallas Cowboys_2017,Oakland Raiders_2017,20,17,-3
1595,15,8:30PM,Atlanta Falcons_2017,Tampa Bay Buccaneers_2017,24,21,-3
1596,16,4:30PM,Indianapolis Colts_2017,Baltimore Ravens_2017,16,23,7
1597,16,8:30PM,Minnesota Vikings_2017,Green Bay Packers_2017,16,0,-16
1598,16,1:00PM,Atlanta Falcons_2017,New Orleans Saints_2017,13,23,10
1599,16,1:00PM,Buffalo Bills_2017,New England Patriots_2017,16,37,21
1600,16,1:00PM,Tampa Bay Buccaneers_2017,Carolina Panthers_2017,19,22,3
1601,16,1:00PM,Cleveland Browns_2017,Chicago Bears_2017,3,20,17
1602,16,1:00PM,Detroit Lions_2017,Cincinnati Bengals_2017,17,26,9
1603,16,1:00PM,Denver Broncos_2017,Washington Redskins_2017,11,27,16
1604,16,1:00PM,Miami Dolphins_2017,Kansas City Chiefs_2017,13,29,16
1605,16,1:00PM,Los Angeles Chargers_2017,New York Jets_2017,14,7,-7
1606,16,1:00PM,Los Angeles Rams_2017,Tennessee Titans_2017,27,23,-4
1607,16,4:05PM,Jacksonville Jaguars_2017,San Francisco 49ers_2017,33,44,11
1608,16,4:25PM,New York Giants_2017,Arizona Cardinals_2017,0,23,23
1609,16,4:25PM,Seattle Seahawks_2017,Dallas Cowboys_2017,21,12,-9
1610,16,4:30PM,Pittsburgh Steelers_2017,Houston Texans_2017,34,6,-28
1611,16,8:30PM,Oakland Raiders_2017,Philadelphia Eagles_2017,10,19,9
1612,17,1:00PM,Chicago Bears_2017,Minnesota Vikings_2017,10,23,13
1613,17,1:00PM,Cleveland Browns_2017,Pittsburgh Steelers_2017,24,28,4
1614,17,1:00PM,Houston Texans_2017,Indianapolis Colts_2017,13,22,9
1615,17,1:00PM,Dallas Cowboys_2017,Philadelphia Eagles_2017,6,0,-6
1616,17,1:00PM,Green Bay Packers_2017,Detroit Lions_2017,11,35,24
1617,17,1:00PM,New York Jets_2017,New England Patriots_2017,6,26,20
1618,17,1:00PM,Washington Redskins_2017,New York Giants_2017,10,18,8
1619,17,4:25PM,Carolina Panthers_2017,Atlanta Falcons_2017,10,22,12
1620,17,4:25PM,Buffalo Bills_2017,Miami Dolphins_2017,22,16,-6
1621,17,4:25PM,Cincinnati Bengals_2017,Baltimore Ravens_2017,31,27,-4
1622,17,4:25PM,Arizona Cardinals_2017,Seattle Seahawks_2017,26,24,-2
1623,17,4:25PM,Kansas City Chiefs_2017,Denver Broncos_2017,27,24,-3
1624,17,4:25PM,Jacksonville Jaguars_2017,Tennessee Titans_2017,10,15,5
1625,17,4:25PM,New Orleans Saints_2017,Tampa Bay Buccaneers_2017,24,31,7
1626,17,4:25PM,Oakland Raiders_2017,Los Angeles Chargers_2017,10,30,20
1627,17,4:25PM,San Francisco 49ers_2017,Los Angeles Rams_2017,34,13,-21
1628,WildCard,4:35PM,Tennessee Titans_2017,Kansas City Chiefs_2017,22,21,-1
1629,WildCard,8:15PM,Atlanta Falcons_2017,Los Angeles Rams_2017,26,13,-13
1630,WildCard,1:05PM,Buffalo Bills_2017,Jacksonville Jaguars_2017,3,10,7
1631,WildCard,4:40PM,Carolina Panthers_2017,New Orleans Saints_2017,26,31,5
1632,Division,4:35PM,Atlanta Falcons_2017,Philadelphia Eagles_2017,10,15,5
1633,Division,8:15PM,Tennessee Titans_2017,New England Patriots_2017,14,35,21
1634,Division,1:05PM,Jacksonville Jaguars_2017,Pittsburgh Steelers_2017,45,42,-3
1635,Division,4:40PM,New Orleans Saints_2017,Minnesota Vikings_2017,24,29,5
1636,ConfChamp,3:05PM,Jacksonville Jaguars_2017,New England Patriots_2017,20,24,4
1637,ConfChamp,6:40PM,Minnesota Vikings_2017,Philadelphia Eagles_2017,7,38,31
1638,SuperBowl,6:30PM,New England Patriots_2017,Philadelphia Eagles_2017,33,41,8
1639,1,8:40PM,Carolina Panthers_2016,Denver Broncos_2016,20,21,1
1640,1,1:04PM,Buffalo Bills_2016,Baltimore Ravens_2016,7,13,6
1641,1,1:04PM,Green Bay Packers_2016,Jacksonville Jaguars_2016,27,23,-4
1642,1,1:05PM,Tampa Bay Buccaneers_2016,Atlanta Falcons_2016,31,24,-7
1643,1,1:05PM,Chicago Bears_2016,Houston Texans_2016,14,23,9
1644,1,1:05PM,Cincinnati Bengals_2016,New York Jets_2016,23,22,-1
1645,1,1:05PM,Cleveland Browns_2016,Philadelphia Eagles_2016,10,29,19
1646,1,1:05PM,San Diego Chargers_2016,Kansas City Chiefs_2016,27,33,6
1647,1,1:05PM,Minnesota Vikings_2016,Tennessee Titans_2016,25,16,-9
1648,1,1:05PM,Oakland Raiders_2016,New Orleans Saints_2016,35,34,-1
1649,1,4:08PM,Miami Dolphins_2016,Seattle Seahawks_2016,10,12,2
1650,1,4:27PM,Detroit Lions_2016,Indianapolis Colts_2016,39,35,-4
1651,1,4:27PM,New York Giants_2016,Dallas Cowboys_2016,20,19,-1
1652,1,8:30PM,New England Patriots_2016,Arizona Cardinals_2016,23,21,-2
1653,1,7:11PM,Pittsburgh Steelers_2016,Washington Redskins_2016,38,16,-22
1654,1,10:20PM,Los Angeles Rams_2016,San Francisco 49ers_2016,0,28,28
1655,2,8:26PM,New York Jets_2016,Buffalo Bills_2016,37,31,-6
1656,2,1:02PM,Cincinnati Bengals_2016,Pittsburgh Steelers_2016,16,24,8
1657,2,1:02PM,Baltimore Ravens_2016,Cleveland Browns_2016,25,20,-5
1658,2,1:02PM,Tennessee Titans_2016,Detroit Lions_2016,16,15,-1
1659,2,1:02PM,Kansas City Chiefs_2016,Houston Texans_2016,12,19,7
1660,2,1:02PM,Miami Dolphins_2016,New England Patriots_2016,24,31,7
1661,2,1:03PM,San Francisco 49ers_2016,Carolina Panthers_2016,27,46,19
1662,2,1:03PM,Dallas Cowboys_2016,Washington Redskins_2016,27,23,-4
1663,2,1:03PM,New Orleans Saints_2016,New York Giants_2016,13,16,3
1664,2,1:05PM,Tampa Bay Buccaneers_2016,Arizona Cardinals_2016,7,40,33
1665,2,4:08PM,Seattle Seahawks_2016,Los Angeles Rams_2016,3,9,6
1666,2,4:25PM,Atlanta Falcons_2016,Oakland Raiders_2016,35,28,-7
1667,2,4:25PM,Indianapolis Colts_2016,Denver Broncos_2016,20,34,14
1668,2,4:25PM,Jacksonville Jaguars_2016,San Diego Chargers_2016,14,38,24
1669,2,8:32PM,Green Bay Packers_2016,Minnesota Vikings_2016,14,17,3
1670,2,8:30PM,Philadelphia Eagles_2016,Chicago Bears_2016,29,14,-15
1671,3,8:26PM,Houston Texans_2016,New England Patriots_2016,0,27,27
1672,3,1:02PM,Arizona Cardinals_2016,Buffalo Bills_2016,18,33,15
1673,3,1:02PM,Minnesota Vikings_2016,Carolina Panthers_2016,22,10,-12
1674,3,1:02PM,Denver Broncos_2016,Cincinnati Bengals_2016,29,17,-12
1675,3,1:02PM,Cleveland Browns_2016,Miami Dolphins_2016,24,30,6
1676,3,1:02PM,Detroit Lions_2016,Green Bay Packers_2016,27,34,7
1677,3,1:02PM,Baltimore Ravens_2016,Jacksonville Jaguars_2016,19,17,-2
1678,3,1:02PM,Washington Redskins_2016,New York Giants_2016,29,27,-2
1679,3,1:02PM,Oakland Raiders_2016,Tennessee Titans_2016,17,10,-7
1680,3,4:05PM,Los Angeles Rams_2016,Tampa Bay Buccaneers_2016,37,32,-5
1681,3,4:05PM,San Francisco 49ers_2016,Seattle Seahawks_2016,18,37,19
1682,3,4:25PM,San Diego Chargers_2016,Indianapolis Colts_2016,22,26,4
1683,3,4:25PM,Pittsburgh Steelers_2016,Philadelphia Eagles_2016,3,34,31
1684,3,4:26PM,New York Jets_2016,Kansas City Chiefs_2016,3,24,21
1685,3,8:31PM,Chicago Bears_2016,Dallas Cowboys_2016,17,31,14
1686,3,8:30PM,Atlanta Falcons_2016,New Orleans Saints_2016,45,32,-13
1687,4,8:26PM,Miami Dolphins_2016,Cincinnati Bengals_2016,7,22,15
1688,4,9:35AM,Indianapolis Colts_2016,Jacksonville Jaguars_2016,27,30,3
1689,4,1:00PM,Detroit Lions_2016,Chicago Bears_2016,14,17,3
1690,4,1:02PM,Buffalo Bills_2016,New England Patriots_2016,16,0,-16
1691,4,1:02PM,Tennessee Titans_2016,Houston Texans_2016,20,27,7
1692,4,1:02PM,Oakland Raiders_2016,Baltimore Ravens_2016,28,27,-1
1693,4,1:03PM,Seattle Seahawks_2016,New York Jets_2016,27,17,-10
1694,4,1:04PM,Carolina Panthers_2016,Atlanta Falcons_2016,33,48,15
1695,4,1:05PM,Cleveland Browns_2016,Washington Redskins_2016,20,31,11
1696,4,4:05PM,Denver Broncos_2016,Tampa Bay Buccaneers_2016,27,7,-20
1697,4,4:25PM,Los Angeles Rams_2016,Arizona Cardinals_2016,17,13,-4
1698,4,4:25PM,Dallas Cowboys_2016,San Francisco 49ers_2016,24,17,-7
1699,4,4:25PM,New Orleans Saints_2016,San Diego Chargers_2016,35,34,-1
1700,4,8:30PM,Kansas City Chiefs_2016,Pittsburgh Steelers_2016,14,43,29
1701,4,8:35PM,New York Giants_2016,Minnesota Vikings_2016,10,24,14
1702,5,8:27PM,Arizona Cardinals_2016,San Francisco 49ers_2016,33,21,-12
1703,5,1:02PM,Chicago Bears_2016,Indianapolis Colts_2016,23,29,6
1704,5,1:02PM,New England Patriots_2016,Cleveland Browns_2016,33,13,-20
1705,5,1:02PM,Philadelphia Eagles_2016,Detroit Lions_2016,23,24,1
1706,5,1:02PM,Tennessee Titans_2016,Miami Dolphins_2016,30,17,-13
1707,5,1:02PM,New York Jets_2016,Pittsburgh Steelers_2016,13,31,18
1708,5,1:03PM,Washington Redskins_2016,Baltimore Ravens_2016,16,10,-6
1709,5,1:05PM,Houston Texans_2016,Minnesota Vikings_2016,13,31,18
1710,5,4:05PM,Atlanta Falcons_2016,Denver Broncos_2016,23,16,-7
1711,5,4:25PM,Buffalo Bills_2016,Los Angeles Rams_2016,30,19,-11
1712,5,4:25PM,Cincinnati Bengals_2016,Dallas Cowboys_2016,14,28,14
1713,5,4:25PM,San Diego Chargers_2016,Oakland Raiders_2016,31,34,3
1714,5,8:30PM,New York Giants_2016,Green Bay Packers_2016,16,23,7
1715,5,8:04PM,Tampa Bay Buccaneers_2016,Carolina Panthers_2016,17,14,-3
1716,6,8:25PM,Denver Broncos_2016,San Diego Chargers_2016,13,21,8
1717,6,1:02PM,San Francisco 49ers_2016,Buffalo Bills_2016,16,45,29
1718,6,1:02PM,Jacksonville Jaguars_2016,Chicago Bears_2016,17,16,-1
1719,6,1:02PM,Cincinnati Bengals_2016,New England Patriots_2016,17,35,18
1720,6,1:02PM,Cleveland Browns_2016,Tennessee Titans_2016,26,28,2
1721,6,1:02PM,Los Angeles Rams_2016,Detroit Lions_2016,28,31,3
1722,6,1:02PM,Pittsburgh Steelers_2016,Miami Dolphins_2016,15,30,15
1723,6,1:02PM,Baltimore Ravens_2016,New York Giants_2016,23,27,4
1724,6,1:03PM,Philadelphia Eagles_2016,Washington Redskins_2016,20,27,7
1725,6,1:03PM,Carolina Panthers_2016,New Orleans Saints_2016,38,41,3
1726,6,4:05PM,Kansas City Chiefs_2016,Oakland Raiders_2016,26,10,-16
1727,6,4:25PM,Dallas Cowboys_2016,Green Bay Packers_2016,30,16,-14
1728,6,4:26PM,Atlanta Falcons_2016,Seattle Seahawks_2016,24,26,2
1729,6,8:32PM,Indianapolis Colts_2016,Houston Texans_2016,23,26,3
1730,6,8:30PM,New York Jets_2016,Arizona Cardinals_2016,3,28,25
1731,7,8:26PM,Chicago Bears_2016,Green Bay Packers_2016,10,26,16
1732,7,9:31AM,New York Giants_2016,Los Angeles Rams_2016,17,10,-7
1733,7,1:02PM,Oakland Raiders_2016,Jacksonville Jaguars_2016,33,16,-17
1734,7,1:02PM,Minnesota Vikings_2016,Philadelphia Eagles_2016,10,21,11
1735,7,1:02PM,Buffalo Bills_2016,Miami Dolphins_2016,25,28,3
1736,7,1:02PM,Cleveland Browns_2016,Cincinnati Bengals_2016,17,31,14
1737,7,1:02PM,Indianapolis Colts_2016,Tennessee Titans_2016,34,26,-8
1738,7,1:02PM,Washington Redskins_2016,Detroit Lions_2016,17,20,3
1739,7,1:03PM,New Orleans Saints_2016,Kansas City Chiefs_2016,21,27,6
1740,7,1:04PM,Baltimore Ravens_2016,New York Jets_2016,16,24,8
1741,7,4:05PM,San Diego Chargers_2016,Atlanta Falcons_2016,33,30,-3
1742,7,4:05PM,Tampa Bay Buccaneers_2016,San Francisco 49ers_2016,34,17,-17
1743,7,4:25PM,New England Patriots_2016,Pittsburgh Steelers_2016,27,16,-11
1744,7,8:30PM,Seattle Seahawks_2016,Arizona Cardinals_2016,6,6,0
1745,7,8:30PM,Houston Texans_2016,Denver Broncos_2016,9,27,18
1746,8,8:26PM,Jacksonville Jaguars_2016,Tennessee Titans_2016,22,36,14
1747,8,8:36AM,Washington Redskins_2016,Cincinnati Bengals_2016,27,27,0
1748,8,12:47PM,Arizona Cardinals_2016,Carolina Panthers_2016,20,30,10
1749,8,1:02PM,New England Patriots_2016,Buffalo Bills_2016,41,25,-16
1750,8,1:02PM,New York Jets_2016,Cleveland Browns_2016,31,28,-3
1751,8,1:02PM,Kansas City Chiefs_2016,Indianapolis Colts_2016,30,14,-16
1752,8,1:02PM,Oakland Raiders_2016,Tampa Bay Buccaneers_2016,30,24,-6
1753,8,1:03PM,Seattle Seahawks_2016,New Orleans Saints_2016,20,25,5
1754,8,1:03PM,Detroit Lions_2016,Houston Texans_2016,13,20,7
1755,8,4:05PM,San Diego Chargers_2016,Denver Broncos_2016,19,27,8
1756,8,4:25PM,Green Bay Packers_2016,Atlanta Falcons_2016,32,33,1
1757,8,8:31PM,Philadelphia Eagles_2016,Dallas Cowboys_2016,23,29,6
1758,8,8:31PM,Minnesota Vikings_2016,Chicago Bears_2016,10,20,10
1759,9,8:25PM,Atlanta Falcons_2016,Tampa Bay Buccaneers_2016,43,28,-15
1760,9,1:00PM,Jacksonville Jaguars_2016,Kansas City Chiefs_2016,14,19,5
1761,9,1:00PM,New York Jets_2016,Miami Dolphins_2016,23,27,4
1762,9,1:00PM,Philadelphia Eagles_2016,New York Giants_2016,23,28,5
1763,9,1:00PM,Pittsburgh Steelers_2016,Baltimore Ravens_2016,14,21,7
1764,9,1:00PM,Dallas Cowboys_2016,Cleveland Browns_2016,35,10,-25
1765,9,1:00PM,Detroit Lions_2016,Minnesota Vikings_2016,22,16,-6
1766,9,4:05PM,Carolina Panthers_2016,Los Angeles Rams_2016,13,10,-3
1767,9,4:05PM,New Orleans Saints_2016,San Francisco 49ers_2016,41,23,-18
1768,9,4:25PM,Indianapolis Colts_2016,Green Bay Packers_2016,31,26,-5
1769,9,4:25PM,Tennessee Titans_2016,San Diego Chargers_2016,35,43,8
1770,9,8:30PM,Denver Broncos_2016,Oakland Raiders_2016,20,30,10
1771,9,8:30PM,Buffalo Bills_2016,Seattle Seahawks_2016,25,31,6
1772,10,8:25PM,Cleveland Browns_2016,Baltimore Ravens_2016,7,28,21
1773,10,1:00PM,Kansas City Chiefs_2016,Carolina Panthers_2016,20,17,-3
1774,10,1:00PM,Chicago Bears_2016,Tampa Bay Buccaneers_2016,10,36,26
1775,10,1:00PM,Green Bay Packers_2016,Tennessee Titans_2016,25,47,22
1776,10,1:00PM,Houston Texans_2016,Jacksonville Jaguars_2016,24,21,-3
1777,10,1:00PM,Minnesota Vikings_2016,Washington Redskins_2016,20,26,6
1778,10,1:00PM,Atlanta Falcons_2016,Philadelphia Eagles_2016,15,24,9
1779,10,1:00PM,Denver Broncos_2016,New Orleans Saints_2016,25,23,-2
1780,10,1:00PM,Los Angeles Rams_2016,New York Jets_2016,9,6,-3
1781,10,4:05PM,Miami Dolphins_2016,San Diego Chargers_2016,31,24,-7
1782,10,4:25PM,San Francisco 49ers_2016,Arizona Cardinals_2016,20,23,3
1783,10,4:25PM,Dallas Cowboys_2016,Pittsburgh Steelers_2016,35,30,-5
1784,10,8:30PM,Seattle Seahawks_2016,New England Patriots_2016,31,24,-7
1785,10,8:30PM,Cincinnati Bengals_2016,New York Giants_2016,20,21,1
1786,11,8:25PM,New Orleans Saints_2016,Carolina Panthers_2016,20,23,3
1787,11,1:00PM,Buffalo Bills_2016,Cincinnati Bengals_2016,16,12,-4
1788,11,1:00PM,Chicago Bears_2016,New York Giants_2016,16,22,6
1789,11,1:00PM,Tennessee Titans_2016,Indianapolis Colts_2016,17,24,7
1790,11,1:00PM,Arizona Cardinals_2016,Minnesota Vikings_2016,24,30,6
1791,11,1:00PM,Baltimore Ravens_2016,Dallas Cowboys_2016,17,27,10
1792,11,1:00PM,Jacksonville Jaguars_2016,Detroit Lions_2016,19,26,7
1793,11,1:00PM,Tampa Bay Buccaneers_2016,Kansas City Chiefs_2016,19,17,-2
1794,11,1:00PM,Pittsburgh Steelers_2016,Cleveland Browns_2016,24,9,-15
1795,11,4:05PM,Miami Dolphins_2016,Los Angeles Rams_2016,14,10,-4
1796,11,4:25PM,New England Patriots_2016,San Francisco 49ers_2016,30,17,-13
1797,11,4:25PM,Philadelphia Eagles_2016,Seattle Seahawks_2016,15,26,11
1798,11,8:30PM,Green Bay Packers_2016,Washington Redskins_2016,24,42,18
1799,11,8:30PM,Houston Texans_2016,Oakland Raiders_2016,20,27,7
1800,12,12:30PM,Minnesota Vikings_2016,Detroit Lions_2016,13,16,3
1801,12,4:30PM,Washington Redskins_2016,Dallas Cowboys_2016,26,31,5
1802,12,8:30PM,Pittsburgh Steelers_2016,Indianapolis Colts_2016,28,7,-21
1803,12,1:00PM,Arizona Cardinals_2016,Atlanta Falcons_2016,19,38,19
1804,12,1:00PM,Jacksonville Jaguars_2016,Buffalo Bills_2016,21,28,7
1805,12,1:00PM,Tennessee Titans_2016,Chicago Bears_2016,27,21,-6
1806,12,1:00PM,Cincinnati Bengals_2016,Baltimore Ravens_2016,14,19,5
1807,12,1:00PM,San Diego Chargers_2016,Houston Texans_2016,21,13,-8
1808,12,1:00PM,San Francisco 49ers_2016,Miami Dolphins_2016,24,31,7
1809,12,1:00PM,Los Angeles Rams_2016,New Orleans Saints_2016,21,49,28
1810,12,1:00PM,New York Giants_2016,Cleveland Browns_2016,27,13,-14
1811,12,4:05PM,Seattle Seahawks_2016,Tampa Bay Buccaneers_2016,5,14,9
1812,12,4:25PM,Carolina Panthers_2016,Oakland Raiders_2016,32,35,3
1813,12,4:25PM,New England Patriots_2016,New York Jets_2016,22,17,-5
1814,12,8:30PM,Kansas City Chiefs_2016,Denver Broncos_2016,30,27,-3
1815,12,8:30PM,Green Bay Packers_2016,Philadelphia Eagles_2016,27,13,-14
1816,13,7:25PM,Dallas Cowboys_2016,Minnesota Vikings_2016,17,15,-2
1817,13,1:00PM,Kansas City Chiefs_2016,Atlanta Falcons_2016,29,28,-1
1818,13,1:00PM,San Francisco 49ers_2016,Chicago Bears_2016,6,26,20
1819,13,1:00PM,Philadelphia Eagles_2016,Cincinnati Bengals_2016,14,32,18
1820,13,1:00PM,Denver Broncos_2016,Jacksonville Jaguars_2016,20,10,-10
1821,13,1:00PM,Detroit Lions_2016,New Orleans Saints_2016,28,13,-15
1822,13,1:00PM,Houston Texans_2016,Green Bay Packers_2016,13,21,8
1823,13,1:00PM,Miami Dolphins_2016,Baltimore Ravens_2016,6,38,32
1824,13,1:00PM,Los Angeles Rams_2016,New England Patriots_2016,10,26,16
1825,13,4:05PM,Buffalo Bills_2016,Oakland Raiders_2016,24,38,14
1826,13,4:25PM,Washington Redskins_2016,Arizona Cardinals_2016,23,31,8
1827,13,4:25PM,New York Giants_2016,Pittsburgh Steelers_2016,14,24,10
1828,13,4:25PM,Tampa Bay Buccaneers_2016,San Diego Chargers_2016,28,21,-7
1829,13,8:30PM,Carolina Panthers_2016,Seattle Seahawks_2016,7,40,33
1830,13,8:30PM,Indianapolis Colts_2016,New York Jets_2016,41,10,-31
1831,14,8:25PM,Oakland Raiders_2016,Kansas City Chiefs_2016,13,21,8
1832,14,1:00PM,Pittsburgh Steelers_2016,Buffalo Bills_2016,27,20,-7
1833,14,1:00PM,San Diego Chargers_2016,Carolina Panthers_2016,16,28,12
1834,14,1:00PM,Chicago Bears_2016,Detroit Lions_2016,17,20,3
1835,14,1:00PM,Cincinnati Bengals_2016,Cleveland Browns_2016,23,10,-13
1836,14,1:00PM,Houston Texans_2016,Indianapolis Colts_2016,22,17,-5
1837,14,1:00PM,Arizona Cardinals_2016,Miami Dolphins_2016,23,26,3
1838,14,1:00PM,Denver Broncos_2016,Tennessee Titans_2016,10,13,3
1839,14,1:00PM,Minnesota Vikings_2016,Jacksonville Jaguars_2016,25,16,-9
1840,14,1:00PM,Washington Redskins_2016,Philadelphia Eagles_2016,27,22,-5
1841,14,4:05PM,New York Jets_2016,San Francisco 49ers_2016,23,17,-6
1842,14,4:25PM,Atlanta Falcons_2016,Los Angeles Rams_2016,42,14,-28
1843,14,4:25PM,Seattle Seahawks_2016,Green Bay Packers_2016,10,38,28
1844,14,4:25PM,New Orleans Saints_2016,Tampa Bay Buccaneers_2016,11,16,5
1845,14,8:30PM,Dallas Cowboys_2016,New York Giants_2016,7,10,3
1846,14,8:30PM,Baltimore Ravens_2016,New England Patriots_2016,23,30,7
1847,15,8:25PM,Los Angeles Rams_2016,Seattle Seahawks_2016,3,24,21
1848,15,8:25PM,Miami Dolphins_2016,New York Jets_2016,34,13,-21
1849,15,1:00PM,Cleveland Browns_2016,Buffalo Bills_2016,13,33,20
1850,15,1:00PM,Green Bay Packers_2016,Chicago Bears_2016,30,27,-3
1851,15,1:00PM,Pittsburgh Steelers_2016,Cincinnati Bengals_2016,24,20,-4
1852,15,1:00PM,Indianapolis Colts_2016,Minnesota Vikings_2016,34,6,-28
1853,15,1:00PM,Detroit Lions_2016,New York Giants_2016,6,17,11
1854,15,1:00PM,Jacksonville Jaguars_2016,Houston Texans_2016,20,21,1
1855,15,1:00PM,Tennessee Titans_2016,Kansas City Chiefs_2016,19,17,-2
1856,15,1:00PM,Philadelphia Eagles_2016,Baltimore Ravens_2016,26,27,1
1857,15,4:05PM,San Francisco 49ers_2016,Atlanta Falcons_2016,13,41,28
1858,15,4:05PM,New Orleans Saints_2016,Arizona Cardinals_2016,48,41,-7
1859,15,4:25PM,New England Patriots_2016,Denver Broncos_2016,16,3,-13
1860,15,4:25PM,Oakland Raiders_2016,San Diego Chargers_2016,19,16,-3
1861,15,8:30PM,Tampa Bay Buccaneers_2016,Dallas Cowboys_2016,20,26,6
1862,15,8:30PM,Carolina Panthers_2016,Washington Redskins_2016,26,15,-11
1863,16,8:25PM,New York Giants_2016,Philadelphia Eagles_2016,19,24,5
1864,16,1:00PM,Atlanta Falcons_2016,Carolina Panthers_2016,33,16,-17
1865,16,1:00PM,Miami Dolphins_2016,Buffalo Bills_2016,34,31,-3
1866,16,1:00PM,Washington Redskins_2016,Chicago Bears_2016,41,21,-20
1867,16,1:00PM,San Diego Chargers_2016,Cleveland Browns_2016,17,20,3
1868,16,1:00PM,Minnesota Vikings_2016,Green Bay Packers_2016,25,38,13
1869,16,1:00PM,Tennessee Titans_2016,Jacksonville Jaguars_2016,17,38,21
1870,16,1:00PM,New York Jets_2016,New England Patriots_2016,3,41,38
1871,16,4:05PM,Indianapolis Colts_2016,Oakland Raiders_2016,25,33,8
1872,16,4:25PM,Arizona Cardinals_2016,Seattle Seahawks_2016,34,31,-3
1873,16,4:25PM,Tampa Bay Buccaneers_2016,New Orleans Saints_2016,24,31,7
1874,16,4:25PM,San Francisco 49ers_2016,Los Angeles Rams_2016,22,21,-1
1875,16,8:25PM,Cincinnati Bengals_2016,Houston Texans_2016,10,12,2
1876,16,4:30PM,Baltimore Ravens_2016,Pittsburgh Steelers_2016,27,31,4
1877,16,8:30PM,Denver Broncos_2016,Kansas City Chiefs_2016,10,33,23
1878,16,8:30PM,Detroit Lions_2016,Dallas Cowboys_2016,21,42,21
1879,17,1:00PM,Buffalo Bills_2016,New York Jets_2016,10,30,20
1880,17,1:00PM,Carolina Panthers_2016,Tampa Bay Buccaneers_2016,16,17,1
1881,17,1:00PM,Chicago Bears_2016,Minnesota Vikings_2016,10,38,28
1882,17,1:00PM,Baltimore Ravens_2016,Cincinnati Bengals_2016,10,27,17
1883,17,1:00PM,Cleveland Browns_2016,Pittsburgh Steelers_2016,24,27,3
1884,17,1:00PM,Jacksonville Jaguars_2016,Indianapolis Colts_2016,20,24,4
1885,17,1:00PM,Dallas Cowboys_2016,Philadelphia Eagles_2016,13,27,14
1886,17,1:00PM,Houston Texans_2016,Tennessee Titans_2016,17,24,7
1887,17,1:00PM,New England Patriots_2016,Miami Dolphins_2016,35,14,-21
1888,17,4:25PM,New Orleans Saints_2016,Atlanta Falcons_2016,32,38,6
1889,17,4:25PM,Arizona Cardinals_2016,Los Angeles Rams_2016,44,6,-38
1890,17,4:25PM,Oakland Raiders_2016,Denver Broncos_2016,6,24,18
1891,17,4:25PM,Kansas City Chiefs_2016,San Diego Chargers_2016,37,27,-10
1892,17,4:25PM,New York Giants_2016,Washington Redskins_2016,19,10,-9
1893,17,4:25PM,Seattle Seahawks_2016,San Francisco 49ers_2016,25,23,-2
1894,17,8:30PM,Green Bay Packers_2016,Detroit Lions_2016,31,24,-7
1895,WildCard,4:35PM,Oakland Raiders_2016,Houston Texans_2016,14,27,13
1896,WildCard,8:15PM,Detroit Lions_2016,Seattle Seahawks_2016,6,26,20
1897,WildCard,1:05PM,Miami Dolphins_2016,Pittsburgh Steelers_2016,12,30,18
1898,WildCard,4:40PM,New York Giants_2016,Green Bay Packers_2016,13,38,25
1899,Division,4:35PM,Seattle Seahawks_2016,Atlanta Falcons_2016,20,36,16
1900,Division,8:15PM,Houston Texans_2016,New England Patriots_2016,16,34,18
1901,Division,4:40PM,Green Bay Packers_2016,Dallas Cowboys_2016,34,31,-3
1902,Division,8:20PM,Pittsburgh Steelers_2016,Kansas City Chiefs_2016,18,16,-2
1903,ConfChamp,3:05PM,Green Bay Packers_2016,Atlanta Falcons_2016,21,44,23
1904,ConfChamp,6:40PM,Pittsburgh Steelers_2016,New England Patriots_2016,17,36,19
1905,SuperBowl,6:30PM,Atlanta Falcons_2016,New England Patriots_2016,28,34,6
